小苹果	筷子兄弟
泡沫	G.E.M.邓紫棋
爸爸去哪儿	林志颖,Kimi,张亮,张悦轩,郭涛,郭子睿,王岳伦,王诗龄
时间都去哪儿了	王铮亮
卷珠帘	霍尊
我们好像在哪见过	小柯,叶蓓
坑爹	高维那
千千阙歌	陈慧娴
自由自在	凤凰传奇
红豆	王菲
光辉岁月	Beyond
朋友别哭	吕方
我可以抱你吗	张惠妹
张灯结彩	皆大欢喜
平凡之路	朴树
寂寞	谢容儿
小伙伴们都惊呆了	王麟
金玉良缘	李琦
等你等了那么久	祁隆,乐凡
爱你1314	正月十五
生来彷徨	汪峰
做你心上的人	NULL
愿得一人心(剧场版)	李行亮,雨宗林
终于等到你	张靓颖
大海	张雨生
男人歌	小沈阳,高进
愿得一人心	李行亮,雨宗林
存在	汪峰
夜空中最亮的星(Remix版)	逃跑计划乐队
开门大吉	凤凰传奇
时间煮雨	郁可唯
趁早	李琦
我只在乎你	邓丽君
倩女幽魂	张国荣
倍儿爽	大张伟
最炫民族风	凤凰传奇
月亮惹的祸	张宇
后会无期	G.E.M.邓紫棋
我让你飞	高维那
怎么说我不爱你	李琦
勇敢勇敢	黄勇
兄弟抱一下	庞龙
荷塘月色	凤凰传奇
夜空中最亮的星	张恒远
好男人都死哪儿去了	崔子格
把悲伤留给自己	陈升
稳稳的幸福	陈奕迅
又见山里红	祁隆
想唱就唱	TFBOYS
红日	李克勤
青春修炼手册	TFBOYS
答案	杨坤,郭采洁
房间	刘瑞琦
单身情歌	林志炫
吻别	张学友
因为爱情	王菲,陈奕迅
我从草原来	凤凰传奇
中国味道	凤凰传奇
逆战	张杰
父亲	筷子兄弟
一万个舍不得	庄心妍
喜欢你	G.E.M.邓紫棋
一场游戏一场梦	王杰
十年	陈奕迅
Let It Go	Demi Lovato
致青春	王菲
寂寞的人伤心的歌	龙梅子,杨海彪
至少还有你	林忆莲
当我想你的时候	汪峰
女人花	梅艳芳
我是不是你最疼爱的人	萱萱
北京北京	汪峰
山水之间	许嵩
我的歌声里	曲婉婷
一起摇摆(抢鲜版)	汪峰
男人哭吧不是罪	刘德华
你给我听好	陈奕迅
追梦人	凤飞飞
老男孩	筷子兄弟
DJ万万岁	王绎龙
倍儿爽 (官方正式版)	大张伟
爱情路	郑源
怒放的生命	汪峰
多情的月光	正月十五
我爱你胜过你爱我	冷漠,杨小曼
心会跟爱一起走	郭峰,陈洁仪
一起摇摆	汪峰
月光 (Moonlight)	EXO-M
爸爸去哪儿 第二季	曹格,Joe,Grace,Feynman,杨阳洋,贝儿,黄多多,吴镇宇,陆毅,黄磊,杨威
闹够了没有	赖伟锋
羞答答的姑娘我爱你	李贵府
后来	刘若英
错过了缘分错过你	冷漠,何龙雨
Angel	Sarah McLachlan
男人好难	沙宝亮,黄渤
再回首	姜育恒
海阔天空	Beyond
他不爱我	李琦
虹之间	金贵晟
我好想你	苏打绿
冰雨	刘德华
蓝莲花	张恒远,赵晗
盛开	玖月奇迹
套马杆	乌兰图雅
心雨	杨钰莹,毛宁
甜蜜蜜	邓丽君
把你宠坏	正月十五
白天不懂夜的黑	那英
惊鸿一面	许嵩,黄龄
老婆最大	崔子格
时间煮雨	吴亦凡
我们的歌谣	凤凰传奇
预谋	许佳慧
宝贝去哪儿	王诗龄,李燃,Kimi,寇静,李湘,田雨橙,郭子睿,张悦轩,叶一茜,陈若仪
卓玛	降央卓玛
Moves Like Jagger	Maroon 5,Christina Aguilera
中国范儿	玖月奇迹
我唱故我在	吉克隽逸
唐古拉Dj版	王麟,完玛三智
愿得一人心	李行亮
Call Me Maybe	Carly Rae Jepsen
我悄悄地蒙上你的眼睛	高明骏,陈艾湄
浮夸	陈奕迅
青春	张恒远
一起摇摆	汪峰,张恒远,毕夏,单冲锋,孟楠
风吹麦浪	李健,孙俪
春天里	汪峰
包容	郑源
Lemon Tree	苏慧伦
The Fox	Ylvis
勇气	梁静茹
剑心	张杰
Stronger (What Doesn'T Kill You)	Kelly Clarkson
传奇	王菲
为爱相随	韩雷,路默依
不再联系	程响
不再见	陈学冬
你把我灌醉	邓紫棋
轻轻的告诉你	杨钰莹
爱一点	王力宏,章子怡
蓝莲花	许巍
山风一样自由	阿鲁阿卓
同桌的你	老狼
思密达	王麟
大地	Beyond
안녕 (再见)	孝琳(Sistar)
童年	罗大佑
不再联系	夏天Alex
王妃	萧敬腾
当爱已成往事	张国荣
阴天	莫文蔚
他不懂	张杰
如果缘只到遇见	吴奇隆,严艺丹
夜夜夜夜	齐秦
残酷月光	萱萱
容易受伤的女人	王菲
猛龙过江	筷子兄弟
追梦赤子心	张恒远
在水一方	邓丽君
心火	姚贝娜
很有味道	格格
遇见	孙燕姿
董小姐	宋冬野
女人不是妖	司徒兰芳
卜卦	崔子格
鲁冰花	甄妮
牵手	苏芮
飞天	凤凰传奇
记得	李琦
奢香夫人	凤凰传奇
其实我很在乎你	谢容儿
黄昏	周传雄
如果没有你	莫文蔚
要爱爱	王麟
爱你的宿命	张信哲
我们好像在哪见过	杨宗纬,叶蓓
爱是你我	刀郎,云朵,王翰仪
待我长发及腰	尚雯婕
战争世界	姚贝娜
趁早	张宇
江南Style	Psy
情非得已	庾澄庆
好久不见	陈奕迅
马上有钱	朱贝贝
晴	汪苏泷
我最亲爱的	张惠妹
我很丑，可是我很温柔	赵传
鸿雁	呼斯楞
我相信	杨培安
My Destiny	Lyn
Summer Time	吉克隽逸,Snoop dogg
夜空中最亮的星	escape plan逃跑计划
The Monster	Eminem,Rihanna
像梦一样自由	汪峰
当爱情离开的时候	王麟
铁血丹心	罗文,甄妮
上海滩	叶丽仪
谈何容易	韩红
爱不可及 （电影《触不可及》主题曲）	王菲
突然的自我	伍佰
最熟悉的陌生人	萧亚轩
心痛2013	小山
We Are One (Ole Ola)	Pitbull,Jennifer Lopez,Claudia Leitte
爱，不解释	张杰
越热闹越孤单	许诺
爱情转移	陈奕迅
Super Star	S.H.E
拥抱你	刘思涵
十七岁的雨季	林志颖
我的好兄弟	高进,小沈阳
无所谓	杨坤
月到天心处	吉克隽逸
领悟	辛晓琪
独角戏	许茹芸
爱的世界只有你	祁隆,乐凡
回忆的沙漏	G.E.M.邓紫棋
相思风雨中	张学友,汤宝如
大声说我爱你	小山
红尘情歌 - 对唱版 芦丽红	高安
好久不见	陈奕迅
自由飞翔	凤凰传奇
唱着情歌流着泪	祁隆
胆小鬼	梁咏琪
三寸天堂	严艺丹
给你们	张宇
痴心绝对	李圣杰
相见恨晚	彭佳慧
不唱情歌	姚贝娜
可以了	陈奕迅
漫步	许巍
郎的诱惑	凤凰传奇
真的爱你	Beyond
偏偏喜欢你	陈百强
那些年	胡夏
笑红尘	陈淑桦
泡沫	邓紫棋
烟花易冷	林志炫
我不是江南Style	妞妞（好声音学员）
不再联系	崔子格,夏天Alex
感到幸福你就拍拍手	凤凰传奇
中国吉祥	玖月奇迹
伤不起	王麟
那些花儿	朴树
趁你还年轻	华晨宇
I Knew You Were Trouble	Taylor Swift
伤心城市	冷漠
许Sir思密达	王麟,老猫
策马奔腾	凤凰传奇
以为爱情没有了	叶蓓
你懂得	小沈阳,沈春阳
后知后觉	李琦,张惠妹
雨一直下	张宇
一路上有你	张学友
兄弟难当	杜歌
爱情码头	郑源
幸运符号	TFBOYS
大声唱	凤凰传奇
天籁传奇	凤凰传奇
泪满天	龙梅子
我的要求不算高	黄渤
呼伦贝尔大草原	降央卓玛
爱	小虎队
西海情歌	降央卓玛
Counting Stars	OneRepublic
Baby	Justin Bieber
Trouble Is A Friend	Lenka
南海姑娘	邓丽君
入戏太深	郑源
青花瓷	周杰伦
一点一滴	羽泉
一直很安静	阿桑
闯码头DJ版	大哲
美人吟	李玲玉
北国之春	邓丽君
爱我的人和我爱的人	裘海正
美酒加咖啡	邓丽君
魔法城堡	TFBOYS
你把爱情给了谁	龙梅子
红玫瑰	陈奕迅
追梦赤子心	GALA
生如夏花	毕夏
琵琶语	林海
要死就一定要死在你手里	杨坤
天使的指纹	孙燕姿
Maps	Maroon 5
花心	周华健
上瘾 (Overdose)	EXO-M
你是我的眼	林宥嘉
不再犹豫	Beyond
你最珍贵	张学友,高慧君
萍聚	李翊君,孙建平
朋友	臧天朔
永远的兄弟	刀郎
Marry You	Bruno Mars
光阴的故事	黄晓明,邓超,佟大为
DJ版漂亮的姑娘就要嫁人啦	龙梅子,老猫
一生无悔	高安,杭娇
那些年	阚立文
新贵妃醉酒	李玉刚
花开那年	魏晨
冲动的惩罚	刀郎
星期六	罗百吉
像梦一样自由	毕夏
把命都给你了	黄海波
蹦吧啦 Bo Ba La	DJ小可
空城	金志文
哥有老婆	纪晓斌
大悲咒	佛教音乐
情非得已	李敏镐,庾澄庆
微笑以后	张靓颖
What Makes You Beautiful	One Direction
有一点动心	张信哲,刘嘉玲
绿旋风	凤凰传奇
Gentleman	PSY
每天一点新	萧敬腾
咿呦	张恒远
勇敢的心	汪峰
做你心上的人(DJ阿远 Mix)	唐古
真实	李琦
讲不出再见	谭咏麟
Gentleman	戴爱玲,Victor Lau
爱情专属权	龙梅子,老猫
敖包相会	刀郎
我和草原有个约定	降央卓玛
东风破	周杰伦
高山流水	古筝
你是我的男神	周艳泓
夜的钢琴曲	石进
喜欢你	Beyond
狐狸叫	Ylvis
和从前一样（抒情版）	黄勇
剑伤	李易峰
好了伤疤忘了疼	大庆小芳
没那么简单	黄小琥
MAMACITA (哎呀呀)	Super Junior
不再联系	夏天Alex,崔子格
姐姐，为什么你不说话	周艳泓
类似爱情	萧亚轩
因为爱情	王菲,陈奕迅
春暖花开	那英
等你等了那么久	祁隆
煎熬	赵晗
问	梁静茹
服不服	王麟
爱的勇气	曲婉婷
幸福恋人	郑源,沈丹丹
兄弟一条命	简红
也许明天	姚贝娜
朋友的酒	李晓杰
没离开过	林志炫
手掌心	丁当
Timber	Pitbull,Ke$ha
最初的梦想	范玮琪
找一个相爱的理由	晨熙,艾歌
龙卷风	G.E.M.邓紫棋
千年等一回	高胜美
想你的夜	关喆
红山果	安与骑兵
可惜不是你	梁静茹
我愿意	王菲
说谎	林宥嘉
也许在	姚贝娜
看透爱情看透你	冷漠
领悟	孟楠
I'm Yours	李琦
父亲的草原母亲的河	降央卓玛
再见	张震岳
我是一只小小鸟	赵传
记得我爱你	李易峰
Zombie	The Cranberries
光明	汪峰
曲终人散	张宇
怎样	毅光年
伸出手	平安
娱乐天空	陈奕迅
Let It Go	Various Artists,Marsha Milan Londoh,Willemijn Verkaik,Nadezhda Panayotova
特别的爱给特别的你	伍思凯
咬咬你	苍井空
我被爱情下了药	崔子格
大悲咒	印能法师
如果风不再吹	张恒远,汪峰
其实你不懂我的心	童安格
给爱	周艳泓,林依轮
Thunder (雷电)	EXO-M
就当是你为了我	许诺
潇洒走一回	叶倩文
My Love	Westlife
A.I.N.Y.（爱你）	G.E.M.邓紫棋
她妈妈不喜欢我	王矜霖
약속 (约定)	金秀贤
记事本	陈慧琳
爱囚	庄心妍
风雨无阻	周华健
断桥残雪	许嵩
滴答	侃侃
新娘不是我	程响
相信自己	零点乐队
吵架歌	汪苏泷,Hari
云淡风轻	平安
Beat It	Michael Jackson
Because Of You	Kelly Clarkson
如果分开我也爱你（白色情人节版）	关喆
卡西莫多的礼物	华晨宇
完美女人	陈瑞
残酷月光	林宥嘉
海阔天空	信乐团
你到底有没有爱过我	蓝波
如果这都不算爱	张学友
怎么说我不爱你	萧敬腾
清明雨上	许嵩
相爱多么难得	孙子涵,李潇潇
伤心的人别听慢歌 (贯彻快乐)	五月天
走天涯	降央卓玛
火火的姑娘	东方红艳
爱情这杯酒谁喝都得醉	闫旭
斯琴高丽的伤心	斯琴高丽
这条街	NULL
你怎么舍得我难过	黄品源
天使在欧洲	平安
你是我心爱的姑娘	汪峰
情歌继续唱	龙梅子,冷漠
只要有你	那英,孙楠
慢慢	张学友
真的不容易	庄心妍
安静	周杰伦
过期爱情	雨宗林
鹿中的王子	小蓓蕾组合
月半小夜曲	李克勤
情为何物	安东阳,樊桐舟
Apologize	OneRepublic
那就这样吧	动力火车
你把我灌醉	G.E.M.邓紫棋
以后的以后	庄心妍
心如刀割	张学友
烟火里的尘埃	华晨宇
难念的经	周华健
陪你一起看草原	降央卓玛
克卜勒	孙燕姿
凤凰	张玮
向天再借五百年	韩磊
铃铃	萧敬腾,范玮琪
一生所爱	卢冠廷
月半小夜曲	陈慧娴
Roar	Katy Perry
背叛	曹格
我怀念的	孙燕姿
逆态度	张杰
亲爱的小孩	赵薇,黄渤,佟大为,郝蕾
特别的人	方大同
溜溜的情歌	凤凰传奇
星月神话	金莎
我	张国荣
Mr.Mr.	少女时代
今天	刘德华
没有什么不同	曲婉婷
克罗地亚狂想曲	MakSim
太委屈	陶晶莹
飞得更高	汪峰
勿忘心安	张杰
你是对的人	戚薇,俊昊
暗香	沙宝亮
走天涯	龙梅子,老猫
哥已经爱上你啦	老猫
笨小孩	刘德华,柯受良,吴宗宪
素颜	许嵩,何曼婷
原来有你	郑源,郑东
有多少爱可以重来	迪克牛仔
千纸鹤	邰正宵
Sweat	东方神起
虫儿飞	少儿歌曲
祝你一路顺风	吴奇隆
爱的供养	杨幂
我们都一样	张杰
白狐	陈瑞
海阔天空	Beyond
简单爱	周杰伦
一剪梅	费玉清
怎样	戴佩妮
爱江山更爱美人	李丽芬
感恩的心	欧阳菲菲
七夕	许嵩
一丝不挂	陈奕迅
Poker Face	Lady Gaga
邂逅	徐良,杨洋
越难越爱	吴若希
咬住下唇 아랫입술 물고	Esna
想你的365天	李玟
跟着你到天边	吴青峰
拯救	孙楠
晚风	好妹妹乐队
原来你也在这里	刘若英
听海	张惠妹
城里的月光	许美静
他不爱我	莫文蔚
没差（特别版）	吴莫愁
最炫民族风 迪斯科舞曲版	凤凰传奇
夜空中最亮的星	逃跑计划
魔鬼中的天使	田馥甄
忽然之间	莫文蔚
会不会	本兮
再见青春	汪峰
御龙归字谣	凤凰传奇
叶子	萱萱
舞女泪	韩宝仪
滚滚红尘	罗大佑,陈淑桦
一个歌手的情书	周三
洋葱	杨宗纬
流年	王菲
As Long As You Love Me	Justin Bieber
趁早	张惠妹
一帘幽梦	纯音乐
别在我离开之前离开	雷诺儿
要死就一定要死在你手里	莫西子诗,郑钧
爱一个人好难	苏永康
日不落	蔡依林
故乡	许巍
DAY BY DAY	T-ara
原来爱情没有刚刚好	李代沫
其实都没有	杨宗纬
世界第一等	刘德华
天下的姐妹	徐千雅,凤凰传奇
Di Da Di	李玟
孤独患者	陈奕迅
囚鸟	G.E.M.邓紫棋
十一年	邱永传
想把我唱给你听	老狼,小柯,曹芳,王筝
心太软	任贤齐
童话	光良
西海情歌	降央卓玛
白月光	孟楠
山丘	李宗盛
风中有朵雨做的云	孟庭苇
动人的传说	杭娇
我的好兄弟	小沈阳,高进
知足	五月天
爱无反顾	姚贝娜
女王驾到	尚雯婕
哭砂	张惠妹
天下	张杰
我只在乎你	邓丽君
爱无反顾	姚贝娜
无法逃脱	张恒远
失恋阵线联盟	草蜢
小三	冷漠
江南	林俊杰
拯救2013再生版	成龙
牵挂你的人是我	郑源
我的歌声里	李代沫
昨夜星辰	邓丽君
连续混音精选60分钟	罗百吉
自由	李琦
当我孤独的时候还可以抱着你	郑源
我从来没有去过纽约	筷子兄弟
我的小宝气	沈丹丹,郑源
月亮代表我的心	邓丽君
我的天空	南征北战
美丽的草原我的家	降央卓玛
张灯结彩	阿宝,王二妮
阳光总在风雨后	许美静
囚鸟	彭羚
不要说话	陈奕迅
卷珠帘	霍尊,费玉清
爱情发的光	吉克隽逸
十送红军	刀郎
喜欢你	Beyond
潇洒走一回	叶倩文
十二月的奇迹 (Miracles in December)	EXO
老公让我为你捶捶背	崔子格,老猫
倔强	五月天
爱了一辈子	庞龙
为爱痴狂	金志文
一生有你	水木年华
我们都是孤独的	华晨宇
美丽的草原我的家	刀郎
We'll Be There	平安
离开这个地方	许诺
外面的世界	齐秦
水手	郑智化
光辉岁月	Beyond
마음으로만	朴正炫
你抱着我哭	高安
遥远的她	陈奕迅
曾经的你	许巍
空白格	杨宗纬
爱情买卖	慕容晓晓
hold不住的爱	龙梅子,老猫
Since U Been Gone	Kelly Clarkson
唐人	孙子涵
她说	林俊杰
光芒	凤凰传奇
爱与妒忌	阿悄
故乡的原风景	宗次郎
Dance To The Music	李宇春
开始懂了	孙燕姿
战争世界	黑白
相思的债	陈瑞
Young For You	GALA
朋友圈 (专辑版)	王麟
让我欢喜让我忧	周华健
四季	庞龙,吴碧霞
懂你	满文军
龙卷风	周杰伦
唐古拉	王麟
在心里从此永远有个你	高安,牧羊
天后	陈势安
Love Love Love (梦中梦)	EXO-M
过家家	小蓓蕾组合
你到底爱谁	刘嘉亮
洋葱	平安
大笑江湖	小沈阳
披着羊皮的狼	刀郎
漫步人生路	邓丽君
Yesterday Once More	Carpenters
She's Gone	赵晗
记得	张惠妹
破晓以后	张靓颖
高原蓝	乌兰图雅
We Are Never Ever Getting Back Together	Taylor Swift
美丽世界的孤儿	汪峰
藏在记忆里的歌	庞龙
寂寞在唱歌	阿桑
做你心上的人（520告白版）	唐古
雨中漫步	The Daydream
天籁之爱	容中尔甲,旺姆
人间	王菲
依然爱你	王力宏
小情歌	苏打绿
漫步人生路	邓丽君
泡沫	简红
没有情人的情人节	孟庭苇
真的假的	陶晶莹
Young And Beautiful	Lana Del Rey
一眼瞬间	李琦,林芯仪
我是否也在你心中	高安
踏浪	徐怀钰
你不知道的事	王力宏
阴天快乐	陈奕迅
陪你一辈子	凤凰传奇
Hey Jude	钟伟强,毕夏
Beautiful Love	蔡健雅
偏爱	张芸京
离歌	信乐团
采红菱	邓丽君
倍儿爽	大张伟
忘记你我做不到	张学友
弹指一挥间	许嵩
盛夏的果实	莫文蔚
写不完的温柔	G.E.M.邓紫棋
全是爱	凤凰传奇
Good Time	Owl City,Carly Rae Jepsen
With You	周笔畅,Epik High
爱如潮水	张信哲
世上只有妈妈好	小蓓蕾组合
我真的受伤了	张学友
你怎么说	邓丽君
你的微笑	飞儿乐团
无情的情书	动力火车
为爱痴狂	刘若英
心经	王菲
小烦恼没什么大不了	许嵩
More Than Words	Extreme
你的我的	梁博
西海情歌	刀郎
沉默是金	张国荣
谢谢你的爱	刘德华
漂洋过海来看你	李宗盛
爱你没错	张信哲
一亿个伤心	蒙面哥
谁的眼泪在飞	金润吉
恭喜发财	刘德华
小小的太阳	张宇
突然想起你	萧亚轩
花泪	栋梁
哥哥妹妹要安慰DJ版	何龙雨,孙语诺
你的背包	陈奕迅
恰似你的温柔	蔡琴
You Belong With Me	Taylor Swift
一眼初春	孙子涵,Xun,常定晨,小峰峰
无情的雨无情的你	齐秦
安和桥	宋冬野
来生缘	刘德华
漂洋过海来看你	娃娃
一万个理由	郑源
Dare (La La La)	Shakira
小酒窝	林俊杰,蔡卓妍
等你来疼我	平安
我如此爱你	汪峰
A.I.N.Y.	邓紫棋
午夜Dj	王绎龙
火红的萨日朗	乌兰托娅
凡人歌	李宗盛
舞女泪	邓丽君
遇上你是我的缘	央金兰泽
小城故事	邓丽君
私奔	梁博
生命像块石头	杨坤
70后	庞龙
秋天的风	郑源,郑东
曹操	林俊杰
跳伞	纯音乐
初雪	Bandari
你不是真正的快乐	五月天
Sleep With You	Egil Olsen
独家记忆	陈小春
精忠报国	屠洪刚
想神马有神马	李代沫,吴莫愁
母亲	阎维文
Gee	少女时代
You Raise Me Up	Westlife
你是我最爱的女人	冷漠
真英雄	张卫健
父亲	降央卓玛
We Are Young	Fun.,Janelle Monáe
K歌之王	陈奕迅
K歌之王(国语)	陈奕迅
我一见你就笑	邓丽君
明天过后	张杰
群发的我不回	郝云
解脱	张惠妹
泪河	希亚zya
I Believe I Can Fly	R. Kelly
爱吧	崔天琪
火力全开	王力宏
白狐	谢容儿
泡沫	G.E.M.邓紫棋
万物生（中文版）	萨顶顶
屋顶	周杰伦,温岚
天使的翅膀	安琥
最浪漫的事	邓丽君
时间都去哪儿了	王铮亮
庐州月	许嵩
你不在北京	曹轩宾
忘情水	刘德华
如果这就是爱情	张靓颖
Need You Now	Lady Antebellum
月光下的凤尾竹	葫芦丝
电音之王	王绎龙
隐形的翅膀	张韶涵
如梦 (女版)	毛泽少
千百度	许嵩
周三的情书	蔡健雅,周三
雨中飘荡的回忆	降央卓玛
最痛的人	安东阳
我是我的	张靓颖
马航去的地方	马健南
最美的时光	韩晶
She	Groove coverage
跟着你到天边	韩磊
天意	刘德华
沧海一声笑	任贤齐
梦里的泪	张赫宣
手心里的温柔	刀郎
没差	吴莫愁
爱的海洋	曲婉婷
像风一样自由	许巍
醉相思	祁隆
暗里着迷	刘德华
Toxic	Britney Spears
在雨中	汪峰
High歌	张玮
让我一次爱个够+征服+哭不出来+存在	那英,庾澄庆,汪峰,张惠妹
取名回忆的时光	吴莫愁,李代沫
看花灯	小蓓蕾组合
麻雀与小孩	小蓓蕾组合
思念是一种病	张震岳
一千个伤心的理由	张学友
我爱上了寂寞	波拉
天龙八部之宿敌	许嵩
Unforgivable Sinner	Lene Marlin
欠你的太多	小贱
美丽的神话	孙楠,韩红
来生缘	刘德华
爱要坦荡荡	丁丁
冬天的秘密	周传雄
元芳 你怎么看	冷漠,赵小兵
贫瘠之歌	汪峰
倔强	云朵
画	赵雷
倾国倾城	玖月奇迹
当爱在靠近	刘若英
半城烟沙	许嵩
红尘情歌	男女对唱
爱火	蓝琪儿
送别	朴树
情人	刀郎
The Sound Of Silence	Simon & Garfunkel
明天会更好	卓依婷
Love Story	Taylor Swift
最佳损友	陈奕迅
Halo	吉克隽逸
芊芊	回音哥
如果云知道	许茹芸
你是我心内的一首歌	王力宏,任家萱
关不上的窗	周传雄
小情歌	多亮
小小	容祖儿
恒星	张恒远
Summer	久石让
三月	张惠妹
生命	林海
祁式情歌DJ舞曲	祁隆
预谋	许佳慧
又见炊烟	邓丽君
小燕子	小蓓蕾组合
当爱已成往事	林忆莲,李宗盛
生如夏花	朴树
我的秘密 MySecret	NULL
缘分惹的祸	安东阳
大悲咒	齐豫
山丹丹开花红艳艳	王二妮
难道爱一个人有错吗	郑源
蜗牛与黄鹂鸟	小蓓蕾组合
恋曲1990	罗大佑
温柔	五月天
雨花石	石头 (王卓实),李玉刚
一万个对不起	祁隆
是否	邓紫棋
要死就一定死在你手里 (新编)	莫西子诗
最美的问候（小V之歌）	品冠
征服	那英
天空之城	郭燕
新不了情	萧敬腾
秋意浓	张学友
骑大马	张铠麟
青春	汪峰
无地自容	黑豹乐队
Song From A Secret Garden	Secret Garden
月亮代表我的心	邓丽君
今天你要嫁给我	陶喆,蔡依林
Let It Go	Various Artists
伤心城市	NULL
我很快乐	刘惜君
不要在我寂寞的时候说爱我	郑源
酒干倘卖无	苏芮
简单的事	李代沫
落花情	七朵组合
안녕	孝琳(Sistar)
咆哮 (Growl)	EXO
偏偏喜欢你	陈百强
I'm Yours	Jason Mraz
蓝精灵	儿歌
月光 (월광)(Moonlight)	EXO-K
睡公主	G.E.M.邓紫棋
好心分手	卢巧音,王力宏
心术	张宇
离不开你	黄绮珊
比心更痛的眼眸	郑源
等待	韩磊
采茶舞曲(浙江民歌调)	李玲玉
情网	张学友
李白	李荣浩
别哭了宝贝DJ版	皓天
旋木	王菲
白娘子	王麟
千千阙歌	张国荣
Remember The Name	Fort Minor
蒲公英在飞	涂议嘉
天边	降央卓玛
挥不去的情愁	冷漠,陈瑞
呼儿嘿哟	李春波
Run (奔跑)	EXO-M
唱什么都红不了	大张伟
愿得一人心	李行亮
活着	郝云
I Miss You	罗百吉
留一盏灯给你	许诺
如果你幸福	郑源
如果爱有下一回	吴炜
想和你去吹吹风	张学友
后来	金润吉
最美	羽泉
渺小	田馥甄
加德满都的风铃	汪峰
草原夜色美	降央卓玛
Beautiful Dirty Rich	Lady Gaga
原野牧歌	小蓓蕾组合
Rolling in the deep	ADELE
呼伦贝尔大草原	布仁巴雅尔
小小新娘花	NULL
白桦林	朴树
寂寞沙洲冷	周传雄
爱出发	TFBOYS
Trouble Maker	Trouble Maker
你就不要想起我	田馥甄
情人	Beyond
一个像夏天一个像秋天	范玮琪
不浪漫罪名	王杰
牛仔很忙	周杰伦
发如雪	周杰伦
突然想起你	林宥嘉
为了遇见你	戚薇,杨宗纬
一个人的寂寞两个人的错	贺一航
小样儿	安又琪
离不开你	朱克
火辣辣的情歌	乌兰图雅
等你的季节	刘诗诗
云水禅心	古筝佛赞
Shake Your Body	郭富城,罗志祥,蔡依林,吴莫愁
灰姑娘	郑钧
挪威的森林	伍佰
Red Light	f(x)
菊花爆满山	马博
羞答答的玫瑰静悄悄地开	孟庭苇
时光	许巍
我爱的你	严宽,杜若溪
雨蝶	李翊君
再度重相逢	孙露
想着你亲爱的	祁隆
遇见	孙燕姿
爱上一个不回家的人	林忆莲
God Is A Girl	Groove Coverage
Valder Fields	Tamas Wells
爱我你就抱抱我	徐英瀚,段丽阳
手心里的温柔	降央卓玛
你最珍贵	张学友,高慧君
只想一生跟你走	张学友
飘洋过海来看你	娃娃
下一个天亮	郭静
梦的翅膀受了伤	孙露
Melody	萱萱
你一定会成功	筷子兄弟
永恒	林海
你家门前 (너의 집 앞)	金秀贤
我和我的小伙伴们都惊呆了	李贵府
我是不是你最疼爱的人	潘越云
一起吃苦的幸福	EXO-M
有没有人告诉你	陈楚生
一念执着	胡歌,阿兰
梦中的婚礼 - 钢琴曲梦中的婚礼	钢琴曲
映山红	刀郎
藕断丝连	陈瑞
涛声依旧	毛宁
清晨	Bandari
风的季节	Soler
放开那三国	霍尊
真心英雄	成龙,周华健,黄耀明,李宗盛
嗨！Mrs Leta	凤凰传奇
墨绿指甲	戚薇
The Mass	Era
硬币	汪峰
当我想你的时候	单冲峰,倪鹏
多么爱你	零点乐队
去大理	黄渤
错过	祁隆
私奔	郑钧
我要我们在一起	邓紫棋
女儿情	吴静
我是不是你最疼爱的人	李代沫
只对你有感觉	飞轮海,田馥甄
兰花指	阿里郎
如果你也听说	张惠妹
单车	陈奕迅
新包容	马健涛
梦缠绵	冷漠,庄心妍
画心	张靓颖
陪你走到底	张靓颖
浮夸	林志炫
荷塘月色（粤语版）	郑源
下个,路口,见	李宇春
Tik Tok	Ke$ha
稳稳的幸福	孙俪,张译
伤了心的女人怎么了	刘涛
너의 집 앞 (你家门前)	金秀贤
大女人	张宇
我是一粒米	小蓓蕾组合
会呼吸的痛	梁静茹
一个人失忆	薛凯琪
离人	林志炫
遇见	张瑶
盛夏光年	五月天
望月	龚玥
一千个伤心的理由	张学友
随它吧	姚贝娜
Gates Of Dawn	Secret Garden
秋天不回来	王强
God is a Girl	Groove Coverage
Stan	Eminem
闷	王菲
突然好想你	五月天
天耀中华	姚贝娜
Whistle	Flo Rida
故乡	毕夏
Answer	东方神起
红颜劫	姚贝娜
窃窃私语 (Whisper)	少女时代-太蒂徐
Footprints In The Sand	萱萱
2002年的第一场雪	刀郎
时间都去哪儿了	王铮亮
我不想说	杨钰莹
Tik Tok	Ke$ha
爱	孟楠
Wrecking Ball	Miley Cyrus
就现在	吴莫愁
Innocence	Avril Lavigne
Stronger	崔天琪,田丹
燕子	小蓓蕾组合
无底洞	蔡健雅
宁夏	梁静茹
不让我的眼泪陪我过夜	齐秦
情人	G.E.M.邓紫棋
很爱很爱你	刘若英
我的未来不是梦	张雨生
漂亮的姑娘你别怕	李贵府
心墙	郭静
很奇怪我爱你	张杰
泼墨	周华健,张大春
月亮之上	凤凰传奇
背对背拥抱	林俊杰
好时光	霍建华,丁当
微风细雨	邓丽君
All Of Me	John Legend
1987我不知会遇见你	李宇春
似是故人来	梅艳芳
默认	王铮亮
最爱的人伤我最深	张雨生,张惠妹
我期待	张雨生,陶晶莹
Just The Way You Are	Bruno Mars
再见吧 喵小姐	王晓天
爱你比永远多一天 DJ版	许诺
Dear Friend	姚贝娜
不羁的生命	汪峰
用心良苦	张宇
这条街	冷漠,云菲菲
说好的幸福呢	周杰伦
天亮了	韩红
我们的歌	王力宏
谁伴我闯荡	Beyond
我为自己代言	魏晨
朋友	周华健
我终于失去了你	李宗盛
想听听你说谎	金莎
此生不换	青鸟飞鱼
痴情冢	贾青
假如	信乐团
天涯	任贤齐
笑忘书	王菲
红尘情歌	郑源vs蒋珊蓓
我在那一角落患过伤风	冯曦妤
信仰	张信哲
一瞬间	丽江小倩
抽离	徐良,刘丹萌
错过的情人	冷漠,石梅
姑娘我铁了心跟着你啦	龙猫组合
凤凰飞	乌兰图雅
Just One Last Dance	Sarah Connor
Rolling In The Deep	钟伟强
我爱你中国	汪峰
大象拨河	小蓓蕾组合
天空之城	纯音乐
一生中最爱	陈奕迅
一千年以后	林俊杰
寂寞寂寞就好	田馥甄
爱久见人心	梁静茹
着魔	张杰
小方	方大同
凤凰于飞	刘欢
老阿姨	韩磊
Take Me to Your Heart	Michael Learns To Rock
红色高跟鞋	蔡健雅
在舞台中间	平安
有没有一首歌会让你想起我	周华健
天蓝蓝	凤凰传奇
梦醒时分	梁静茹
红尘客栈	周杰伦
我在红尘中遇见你	张冬玲,冷漠
感动天感动地	宇桐非
冰封	萧敬腾
Happy	Pharrell Williams
一块红布	刘彩星,高扬
流浪记	杨宗纬
谢谢你的爱	刘德华
我的眼泪为谁飞	小沈阳
桃花源	腾格尔
如果你不再爱了	罗中旭
富士山下	陈奕迅
Halo	Beyoncé
爱要大声说出来	樊桐舟
朋友的酒	李晓杰
男人的好	张宇
是否我真的一无所有	王杰
站在草原望北京	乌兰图雅
雁南飞	刀郎,黄灿
天路	韩红
五环之歌	王麟,南城二哥
我和我的小伙伴们都惊呆了	王麟
串烧DJ	任军太
走西口	王二妮
秋日私语	理查德·克莱德曼
是非题	范玮琪
相见不如怀念	樊凡
悟	刘德华
Just Give Me A Reason	P!nk
冬天里的一把火	费翔
心痛2009	欢子
白狐	陈瑞
故事	苏打绿
别让情两难	范文芳,张信哲
冷雨夜	Beyond
天黑黑	孙燕姿
剑伤	李易峰
趁早	张惠妹
叹情缘	祁隆
山里红	群星
醉红颜	冷漠
借口	周杰伦
漂亮的姑娘就要嫁人啦	龙梅子,老猫
If I Were A Boy	Beyonce
风继续吹	张国荣
甩葱歌	初音未来
We Will Rock You	Queen
爱江山更爱美人	降央卓玛
口是心非	张雨生
Last Christmas	Taylor Swift
遇见	金润吉
相思渡口	祁隆
咱们结婚吧	齐晨
When You Believe	Whitney Houston,Mariah Carey
Red	Taylor Swift
共圆中国梦	正月十五
回忆的沙漏	邓紫棋
Rolling In The Deep	Kim Yarbrough
每个人都看到了希望	筷子兄弟
火柴天堂	齐秦
尚好的青春	孙燕姿
邻妹妹爱上假宝玉	周艳泓
天高地厚	信乐团
爱情求救号	罗百吉
梁祝	古筝
梦的翅膀受了伤	蒋雪儿
光阴的故事	罗大佑
中国美	玖月奇迹
My Heart Will Go On	Celine Dion,James Horner
我不需要	邱振哲
红星照我去战斗	刀郎
小三(DJ版)	冷漠
三天三夜	歌浴森,张玮
爱情这杯酒谁喝都得醉	孙露
眼泪的名字	谢安琪
When A Man Loves A Woman	金润吉
轻易伤害我(dj版)	沈世爱
伤心的时候可以听情歌	欢子
刀剑如梦	周华健
倩女幽魂	张国荣
囚鸟	张宇
你怎么说	邓丽君
黄梅戏	慕容晓晓
摇篮曲	宝宝的音乐花园
漂洋过海来看你 (Live)	刘明湘
Firework	Katy Perry
新鸳鸯蝴蝶梦	黄安
不值得	曾一鸣
渡口	蔡琴
罗密欧与朱丽叶	理查德·克莱德曼
看透爱情看透你(DJ版)	NULL
River Flows In You	李闰珉
夜的钢琴曲(五)	石进
爱在天地间	降央卓玛
月光	胡彦斌
走天涯	降央卓玛
We Are One (Ole Ola) [The Official 2014 FIFA World Cup Song]	Pitbull,Jennifer Lopez,Claudia Leitte
爱我就跟我走	王鹤铮
爱笑的眼睛	林俊杰
就是爱你	陶喆
隐形的思念	石进
摇摆哥	王绎龙
有何不可	许嵩
青春再见	水木年华,老狼,李健,叶世荣
逍遥叹	胡歌
完美生活	许巍
Mascara（烟熏妆）	G.E.M.邓紫棋
我离开我自己	杨乃文
需要人陪	王力宏
人生何处不相逢	陈慧娴
哥哥你真帅	龙梅子
传奇	李健
一个人	黄铃凯,吴青峰
蜗牛的家	小蓓蕾组合
我不难过	孙燕姿
晴天	周杰伦
恋人未满	S.H.E
Say Something	Christina Aguilera
练习	刘德华
天生不完美	萱萱,那英
我想大声告诉你	樊凡
执着	田震
上海滩	刘德华
如果没有你	郑虹,李代沫
天堂上的妈妈	唐古
斑马,斑马	宋冬野
初雪	EXO
等一分钟	徐誉滕
不请自来	吴莫愁
Kiss The Rain	李闰珉
小美人	崔子格
What Doesn't Kill You (Stronger)	Kelly Clarkson
蒙娜丽莎的眼泪	林志炫
My Destiny	LYn
朋友	周华健
出卖	周传雄
催眠	王菲
Numb (Album Version)	Linkin Park
再遇见	苏打绿
上瘾 (중독)(Overdose)	EXO-K
犹见炊烟	邓丽君
贝加尔湖畔	李健
Drenched	曲婉婷
龙的传人	中国好声音第二季学员
让我一次爱个够	庾澄庆
一无所有	崔健
寂寞旅行	文杰
玫瑰花的葬礼	许嵩
父亲的草原母亲的河	腾格尔
当爱已成往事	林忆莲,李宗盛
Give Me Everything	Pitbull
Amani	Beyond
月亮升起来	降央卓玛
白色恋人	游鸿明
十送红军	宋祖英
田园香	黄雅莉
你是另一个我	黄征
改变自己	王力宏
雨花石	李玉刚
离别的秋天	孙露
Rock N Roll	Avril Lavigne
The World As I See It	Jason Mraz
一路向北	周杰伦
老婆你辛苦了	祁隆
暖暖	梁静茹
最好的朋友	赖伟锋
天下有情人	齐豫,周华健
Your Smile	Bandari
秋殇别恋	牙牙乐,格子兮
你若成风	许嵩,阿布
Only Time	Enya
A Little Love	冯曦妤
彩色的黑	吉克隽逸
爱上你等于爱上了错	张振宇
烟花易冷	周杰伦
这，就是爱	张杰
关不掉的月光	金润吉,庾澄庆
最初的梦想+奔跑+我的未来不是梦	范玮琪,陈羽凡,胡海泉
Moment	李昶旻
下雨天	南拳妈妈
步步	五月天
Let You Go	华晨宇
你	屠洪刚
哥妹情缘	格格,高安
亲爱的那不是爱情	张韶涵
路灯下的小姑娘	杨坤
我要去西藏	乌兰图雅
我和草原有个约定	凤凰传奇
快乐天堂	小蓓蕾组合
听	张杰
我的滑板鞋	庞麦郎
泥娃娃	小蓓蕾组合
涛声依旧	毛宁
倒带	蔡依林
火花	高耀太
草原情哥哥	乌兰图雅
清明上河图	李玉刚
沉默是金	张国荣,许冠杰
想太多	李玖哲
即刻出发	吉克隽逸
兄弟本色	张震岳
月半小夜曲	李克勤
矜持	王菲
Diamonds	Rihanna
错过了缘分错过你 伦巴舞曲	何龙雨
飞得更高	汪峰
天真无邪	胎教音乐
再见 (안녕)	孝琳(Sistar)
悄悄告诉你	范玮琪
再度重相逢	伍佰
高原红	容中尔甲
20岁	崔天琪
说好了不见面	小贱
往事随风	齐秦
两只老虎	儿歌
敖包相会	降央卓玛
穷开心	花儿乐队
夏天的风	温岚
披着羊皮的狼	谭咏麟
梅花三弄	姜育恒
想归想	欧弟
悬崖	萱萱,崔兰花
醉拳	成龙
She Is My Sin	Nightwish
鬼迷心窍	李宗盛
小星星变奏曲	胎教音乐
红颜	胡彦斌
带我到山顶	吉克隽逸
Pacific Rim	Tom Morello
爱情里没有谁对谁错	郑源
小二郎	小蓓蕾组合
分开旅行	刘若英,黄立行
父亲	刘和刚
电台情歌	莫文蔚
Problem	Ariana Grande
煎熬	李佳薇
As Long As You Love Me	Backstreet Boys
我是真的爱你	阚立文,朱克
女人心	陈瑞
最佳幸运 (최고의 행운)	CHEN
恰似你的温柔	邓丽君
最重要的决定	范玮琪
小情歌	苏打绿
逝去的日子	Beyond
你的微笑	侯磊
老婆最大Dj版	崔子格
父亲的草原母亲的河	云飞
Andy	阿杜
还有我	任贤齐
爱上草原爱上你	琪琪格
奔跑	羽泉
爱你是种罪	梦然
网络情缘	侃侃
旅行	许巍
牧羊曲	龚玥
等你爱我	陈奕迅
一念之间	陶喆
迷茫的爱	郭玲
Radioactive	Imagine Dragons
爱情万万岁	高安
我们好像在哪见过(剧场版)	杨宗纬,叶蓓
Love Can Fly	袁娅维
下沙	游鸿明
情书	张学友
民歌大联唱	阿宝
酷	李宇春
光辉岁月	陈奕迅
寂寞先生	曹格
The Show	Lenka
Make Love	BigBang
笔记	周笔畅
下辈子也要找到你	孙露
17岁	刘德华
SEXY LOVE	T-ara
秋画	凤凰传奇
我们的爱	飞儿乐团
安妮	王杰
一块红布	刘明辉
空城	杨坤
谁是我的郎	杨梓
等到烟火清凉	许嵩
白月光	张信哲
要死就一定要死在你手里	莫西子诗
爱的血泪史	冷漠,云菲菲
青蛇	墨明棋妙
水中花	谭咏麟
月亮惹的祸	张宇
爱上蝴蝶	艳乐队
皇后大道东	罗大佑
父亲	龚玥
金玉良缘	贾青
Knockin' On Heaven's Door	毕夏
灰色轨迹	Beyond
我一定要得到你	筷子兄弟
用心良苦	张宇
南方姑娘	赵雷
Heart	TFBOYS
新套马杆	乌兰托娅
因为爱着你	龙梅子
诺言	李翊君
我知道你也很想念	后弦
不小心犯的错	郑源
加州旅馆	老鹰乐队
寂寞的季节	陶喆
你在看孤独的风景	本兮
你还爱我吗	Sara
当我唱起这首歌	星弟,小贱
MR TAXI	少女时代
爱	莫文蔚
摇篮曲	胎教音乐
Let It Go	Idina Menzel
烦恼歌	张学友
没离开过	毅光年,声音乐团
春泥	庾澄庆
Bad Romance	Lady Gaga
这又何必	许佳慧
As Long As You Love Me	Backstreet Boys
女大要出嫁	龙梅子,老猫
从开始到现在	张信哲
激战上海滩	罗百吉
偏爱	谭咏麟
一个人想着一个人	曾沛慈
大海	丁克森
夜夜夜夜	林志炫
男儿当自强	成龙
我知道你很难过	蔡依林
天空之城 - 钢琴 久石让 李家祥	钢琴曲
真心英雄	周华健,成龙,黄耀明,李宗盛
凡人歌	李宗盛
给未来的自己	梁静茹
味道	侯磊
外面的世界	莫文蔚
何必在一起	张杰
一起走过的日子	刘德华
陌生人	蔡健雅
奇迹	G.E.M.邓紫棋
飘雪	陈慧娴
我的秘密	邓紫棋
我只是个传说	小沈阳
Goodbye	少女时代
江湖·闪蝶	河图
Heaven On Earth 人间天上	Bandari
我和草原有个约定	乌兰图雅
未完的承诺	罗志祥
反转	平安
女神经	李宇春
爱投罗网	罗志祥
一辈子的孤单	刘若英
突然心动	陈晓东
不能说出口的诺言	吴奇隆
想起	韩雪
一眼万年	S.H.E
两只蝴蝶	庞龙
海芋恋	萧敬腾
做我老婆好不好	徐誉滕
You Raise Me Up	金润吉
月光	Bandari
到不了	范玮琪
我是一个粉刷匠	小蓓蕾组合
别怪我把你删除	魏枫
不一样	刘雨潼
彩云之南	徐千雅
夜太黑	田园
我相信	吴莫愁
梦驼铃	费玉清
秦淮河畔	纯音乐
Whataya Want From Me	Adam Lambert
等爱的玫瑰	凤凰传奇
我要我们在一起	范晓萱
朋友别哭	吕方
老中医说	许诺
生生世世爱	吴雨霏
一个人(live版)	黄铃凯
手放开	李圣杰
敖包再相会	乌兰托娅,蒙克
邂逅	NULL
我是我的情人	阿悄
白月光	张信哲
Saving All My Love For You	孟楠
过火	张信哲
万水千山总是情	汪明荃
甜甜的	周杰伦
在水一方	邓丽君
FANTASTIC BABY	BIGBANG
你被写在我的歌里	苏打绿,ELLA
画	赵雷
人鬼情未了	理查德·克莱德曼
长城	Beyond
苦咖啡	冷漠
老天爷	范思威
亲爱的你怎么不在我身边	江美琪
魔兽世界 - 游戏 原声	亡灵序曲
人来人往	陈奕迅
待嫁的新娘	凤凰传奇
可爱女人	周杰伦
谢谢你	刀郎
拆弹专家	华晨宇
人面桃花	邓丽君
浮夸	梁君诺
Where Did U Go	G.E.M.邓紫棋
像个孩子	汪峰
僵尸 Zombie	DJ小可
The Rain	久石让
为爱痴狂	刘若英
爱是你我	小沈阳
泪海	许茹芸
宝马车里哭泣的女人（DJ版）	张祥洪
爱一点	莫艳琳
美人鱼	林俊杰
断点	张敬轩
怎么会狠心伤害我	郑源
风雨彩虹铿锵玫瑰	田震
我曾用心爱着你	葛泓语
错爱	庄心妍
当我遇上你	刘德华
他一定很爱你	阿杜
我们都是好孩子	王筝
大城小爱	王力宏
夜夜夜夜	梁静茹
阴谋	张玮
我叫小沈阳	小沈阳
火苗	格格
朋友	周华健
放下所有放不下你	祁隆
心中的日月	王力宏
我的未来式	郭采洁
回到拉萨	郑钧
跟往事干杯	姜育恒
灰色头像	许嵩
其实不想走	周华健
赤裸裸的离开	龙梅子,老猫
广岛之恋	莫文蔚,张洪量
山茶花	邓丽君
嫁妆	安与骑兵
活着多好	陈奕迅
卡农D大调	贵族乐团
时间都去哪了 (京剧版)	霍尊
海绵宝宝	回音哥
王子的新衣	萧敬腾
放生	范逸臣
爱的回归线	陈韵若,陈每文
路边的野花不要采	邓丽君
爱就一个字	张信哲
Yellow	Coldplay
哥妹情缘	高安
花房姑娘	崔健
捉泥鳅	小蓓蕾组合
领悟	关喆
中国话	S.H.E
Love Story	Taylor Swift
熊猫咪咪	小蓓蕾组合
农民	Beyond
观音灵感真言	印能法师
爱我的人请你告诉我（DJ版）	张祥洪
佛说	何晟铭
山丹丹开花红艳艳	阿宝
难道是我上辈子欠了你	郑源
花火	汪峰
我没你想的那么坚强	杨坤
思念的方向	玖月奇迹
伤	张玮
Let Her Go	Passenger
那一天	杨坤
青春	韩红
넘버나인 (No.9)	T-ara
棉花糖	至上励合
谁Control	韩庚
故乡情	降央卓玛
秋意浓	金润吉,非非
请比我爱她	柯震东
最浪漫的事	金志文
像疯了一样	曾一鸣
找一个字代替	邰正宵
北京东路的日子	群星
命运	家家
天空	王菲
你把我灌醉	张赫宣
十一月…还有(November With Love)	东方神起
风吹麦浪	李健
If You Believe	Suby郑
站在高岗上	张惠妹
一生爱你千百回	梅艳芳
黑色幽默	周杰伦
星	邓丽君
滚滚红尘＋闪亮的日子	平安
好日子	宋祖英
Here's To Never Growing Up	Avril Lavigne
左手右手	杨沛宜
希然宁泊 — 自省•心经	萨顶顶
有多少爱可以重来	邓紫棋
爱歆	可歆,群可
暖心	郁可唯
Christmas Day（圣诞节）	EXO
微光	华晨宇
谁明浪子心	王杰
单车恋人	后弦
离别	阿杜
我想大声告诉你	金志文
给我一个吻	邓丽君
每次都想呼喊你的名字	张学友
幸福的两个人	杨梓,陈雅森
不要说话	陈奕迅
记事本	陈慧琳
别再说	孙露
错错错	六哲,陈娟儿
老地方的雨	陈瑞
父亲的草原母亲的河	布仁巴雅尔
旅行的意义	陈绮贞
花心大萝卜	张梅梅
booty music	Deep Side
鱼水情歌	陈瑞
稻草人	林志颖
Hotel California	Eagles
草原之夜	刀郎
Gotta Have You	The weepies
老子明天不上班	谢帝
落花	林心如
小温馨	小贱,可歆
情人都是别人的好	冷漠
欢沁	林海
I Need You Love	杨谨, 沙滩宝贝
2002年的第一场雪	刀郎
Love Never Felt So Good	Michael Jackson
Alwaysonline	林俊杰
宝贝	张悬
橄榄树	齐豫
讲不出再见	谭咏麟
鸿雁	童彤
Right Now (Na Na Na)	Akon
拜新年	凤凰传奇
Seasons In The Sun	Westlife
我在春天等你	杨钰莹
偶尔	邓紫棋
浪人情歌	伍佰
红豆红	龚玥
一言难尽	张宇
月光	胎教音乐
拔萝卜	小蓓蕾组合
爱相随	周华健
依恋	蔡淳佳
洋葱	杨宗纬
越长大越孤单	牛奶咖啡
岁月如歌	陈奕迅
不是因为寂寞才想你	T.R.Y
West Coast	Lana Del Rey
雨中飘荡的回忆	刀郎
Bar Bar Bar	Crayon Pop
梦缠绵	庄心妍,冷漠
军中绿花	小曾
童年	卓依婷
阿里山的姑娘	邓丽君
粉红色的回忆	韩宝仪
遥远的呼唤	央金拉姆
兄弟	刘德华,陈奕迅
求求你给点力 - 加快版 开场舞曲 dj57	Dj
青蛙跳下水	小蓓蕾组合
我是真的爱你	李宗盛
我还想她	林俊杰
爱你一万年	刘德华
爱你却要说分手	冷漠
天空	孟楠
夜夜夜夜	金池
青花	周传雄
一个人走	刘佳
梦里水乡	江珊
棋子	王菲
如果有一天	梁静茹
梦醒时分	陈淑桦
梦一场	萧敬腾
会痛的石头	萧敬腾
Story Of My Life	One Direction
魔鬼中的天使	田馥甄
一起吃苦的幸福	周华健
梵音大悲咒	齐豫
Lovey Dovey	T-ara
原香草	乌兰图雅
星星点灯	郑智化
MAMA	EXO-M
妥协之歌	那英,萱萱,朱克,姚贝娜,侯磊
得到你的人却得不到你的心	欢子
礼物	许巍
Why Nobody Fights	华晨宇
如果没有你	李代沫
Apologize	Timbaland
一笑而过	那英
音乐	罗百吉
寂静的天空	代青塔娜
无与伦比的美丽（声动亚洲）	霍尊
一眼万年	S.H.E
嫁给人民币	李贵府
女儿情	西游记
领悟	李宗盛
西海情歌	刀郎
曾经是我最爱的人	陈瑞
茶山情歌	杨钰莹
亲密爱人	梅艳芳
三万英尺	迪克牛仔
那一夜	罗百吉
那年的情书	江美琪
回到过去	周杰伦
远方	郁可唯
撕夜	阿杜
我相信	张靓颖
雪候鸟	朱克
Nobody	Wonder Girls
容易受伤的女人	王菲
不得不爱	潘玮柏,弦子
渴望	毛阿敏
今生爱的就是你	祁隆
后来	刘若英
The Boys	少女时代
一生何求	陈百强
You Are Not Alone	Michael Jackson
Let It Go	Idina Menzel
给我一个理由忘记	A-Lin
你的样子	林志炫
我不是公主	凤凰传奇
枉凝眉	龚玥
听说爱情回来过	林忆莲
同桌的你	胡夏
入阵曲	五月天
北国之春	蒋大为
天空角落	张楚
摇篮曲	宝宝的音乐花园
今宵多珍重	王若琳
棒棒棒	佚名
High歌	黄龄
枉凝眉	郑绪岚
选择	林子祥,叶倩文
为梦而来	张玮
醉赤壁	林俊杰
再见二丁目	杨千嬅
丢了幸福的猪	姜玉阳
仙剑问情	萧人凤
味道	辛晓琪
安静	纯音乐
三轮车	MC
坏姐姐	王蓉
爱你在心口难开	阿宝
I Will Always Love You	Whitney Houston
Love Will Remember	Selena Gomez & The Scene
你的眼神	蔡琴
말이야(话说)	李弘基
叹情歌（男女对唱版）	高安,司徒兰芳
谢谢你常记得我	邓丽君
挥着翅膀的女孩	容祖儿
彼岸花	夏米雅
Free Loop	Daniel Powter
哭不出来	张惠妹
I Want My Tears Back	Nightwish
我的心一路向北（DJ版）	张祥洪
雾里看花	那英
人质	张惠妹
她来听我的演唱会	张学友
Partita For Double String Orchestra: Iv. Fantasia (Allegro)	邓丽君
想想我	李祥祥
小手拍拍	小蓓蕾组合
伤心为礼物	孙子涵
走在乡间的小路上	卓依婷
爱琴海	央金兰泽
蝴蝶花	小蓓蕾组合
喝酒Blues	张岭
白玫瑰	陈奕迅
Dark Horse	Katy Perry,Juicy J
为情所伤	庄心妍
名利场	汪峰
脱胎换骨	李炜
痒	黄龄
舞女	韩宝仪
驼铃	刀郎
火苗	乌兰托娅
我也不想这样	王菲
母亲	龚玥
黑暗骑士	林俊杰,阿信
Everybody	Ingrid Michaelson
不变的音乐	王绎龙
执着	许巍
酒醉的探戈	邓丽君
Can'T Get Over You	Groove Coverage
我是不是该安静的走开	郭富城
耶耶耶	DJ小可
你知道我在等你吗	张洪量
曾经相爱那么深	龙梅子
旧情绵绵	张学友
菩萨蛮	姚贝娜
稻香	周杰伦
When I Was Your Man	Bruno Mars
让每个人都心碎	桂雨濛,孟楠
掌声响起	凤飞飞
如果的事	范玮琪,张韶涵
你不知道的事	王力宏
忧伤还是快乐	纯音乐
最美的太阳	张杰
情书不包邮	后弦
都要好好的	小沈阳
千年泪	Tank
第一次爱的人	王心凌
哦·想	安与骑兵
再见	张震岳
丝路	梁静茹
蝴蝶泉边	黄雅莉
Love The Way You Lie	Eminem,Rihanna
青春纪念册	可米小子
无间道	刘德华
明年今日	陈奕迅
Hero	Mariah Carey
不如去嗨	易丹
Safe & Sound	Taylor Swift
小白杨	阎维文
当	动力火车
小白脸	谢容儿,侯皓中
星空	理查德·克莱德曼
别让我一个人醉	姜育恒
迷失的纯真（DJ版）	张祥洪
牧羊曲	古筝
Crush	David Archuleta
我的翅膀	崔天琪
Have A Nice Day	Fred Coury
听海	张学友
半醒	刘思涵
但愿人长久	王菲
热雪	魏晨
你的背包	陈奕迅
爱情公寓	王传君,陈赫,孙艺洲,金世佳,娄艺潇,李金铭,邓家佳
永远的战士	刀郎
樱花草	Sweety
青苹果乐园	小虎队
With An Orchid	Yanni
第一次	光良
怀念战友	刀郎
我愿意	阚立文
何日君再来	理查德·克莱德曼
一生中最爱	谭咏麟
到不了	李代沫
爱不爱我	零点乐队
我是真的爱上你	王杰
可惜不是你	梁静茹
离别的车站	孙露
海阔天空	信乐团
梅花三弄	古筝
眼,鼻,嘴 (눈,코,입)	太阳
共你痴痴爱在	容祖儿
最爱	杨宗纬
今生爱上你	高安,张渼壹
好胆你就来	张惠妹
绿光	孙燕姿
不存在的存在	G.E.M.邓紫棋
广岛之恋	莫文蔚,张洪量
Scarborough Fair	Sarah Brightman
你爱我像谁	张卫健
男儿当自强	林子祥
아픈 사랑 (疼痛的爱)	李敏镐
背叛情歌	动力火车
有谁共鸣	张国荣
左边	杨丞琳
张三的歌	齐秦
梦的婚礼	理查德·克莱德曼
有点甜	汪苏泷&by2
卓玛	央金
去大理	郝云
路边的野花不要采	邓丽君
如果爱忘了	戚薇
像个孩子	张恒远,汪峰
摇啊摇	王绎龙
我想有个家	潘美辰
猜不透	丁当
睡在我上铺的兄弟	老狼
最浪漫的事	赵咏华
那一年	许巍
开心的马骝	刘德华
爱你的宿命 (Live)	张碧晨
让我们荡起双桨	小蓓蕾组合
像今天这样的眼泪 (오늘 같은 눈물이)	许阁
倾尽天下	河图
时光隧道	陈奕迅
认真的雪	薛之谦
如果爱能早些说出来	山野
北京北京	梁博,黄勇
伤心太平洋	任贤齐
选择	叶倩文,林子祥
LOVE YOU LIKE A LOVE SONG	Selena Gomez,the Scene
我不愿让你一个人	五月天
呼吸 (Breath)	Chen,张力尹
一路向北	冷漠
爱的魔法	金莎
凭什么说	刘心
琵琶语	纯音乐
Spanish	Craig David
滚滚红尘	陈淑桦
走在冷风中	刘思涵
为了谁	龚玥
皇上吉祥	崔子格
Sparks Fly	Taylor Swift
矜持(电影《前任攻略》主题曲)	姚贝娜
逆战	张杰
永远不分开	李易峰
大闹天宫	毕夏,张恒远
于谦 - 最新力作 爆笑演绎 快乐生活	郭德纲
流着泪的你的脸	任贤齐
老人与海	海鸣威
珊瑚海	周杰伦,Lara
闯码头	大哲
天路(Traditional Version)	韩红
这山这水	降央卓玛
我一个人 (Not Alone)	张力尹
可爱颂	Hari
LA SONG	Rain
三年三天	安与骑兵
开不了口	周杰伦
突然的自我	伍佰
蜗牛 与黄鹂鸟	儿童歌曲
逍遥	霍建华
으르렁 (Growl)	EXO
新年更加要努力	龙梅子,杨德朗
短发	梁咏琪
kiss the rain (雨的印记)	李闰珉
女汉子	王麟
遗憾	李代沫
情歌王	古巨基
至少还有你	林忆莲
心在云上飞	乌兰托娅
Only Girl (In The World)	Rihanna
旅途	平安
从头再来	刘欢
一个人的情歌	带泪的鱼,MC诺
自由行走的花	萨顶顶
甘心情愿	郭峰
爱情shalala	米娜
Melody	陶喆
数鸭子 - 儿童歌曲大全婴儿启蒙歌曲	儿童歌曲
不如承诺来的简单	陈奕迅
天籁之爱	旺姆
致我们终将逝去的青春	赵英俊
原谅	张玉华
过火	张信哲
一生去守候	高安
狼爱上羊	汤潮
相思	毛阿敏
别找我麻烦	蔡健雅
如果没有你	萧敬腾
爱与痛的边缘	王菲
自然	轻音乐,Bandari
情歌悠扬	本兮
偶阵雨	梁静茹
肩上蝶	金志文,汤晓菲
勇敢的代价	丁丁
It's My Life	Bon Jovi
最右	龙梅子,老猫
Just Dance	Lady Gaga
爸爸去哪儿	林志颖,田亮,郭涛,王岳伦,张亮,Kimi,田雨橙,王诗龄,郭子睿,张悦轩
唱过什么歌	金海心
Are You Ready	张惠妹,李琦,塔斯肯,刘雅婷,王拓
飘雪	陈慧娴
凤凰花开的路口	林志炫
爱拼才会赢	叶启田
水墨丹青	李玉刚
那些花儿	范玮琪
爱你在心口难开	王矜霖,米可
兄弟	任贤齐
我爱的人	陈小春
爱情回来了	曹轩宾
流星雨	F4
明天，你好	牛奶咖啡
爱恨情歌 对唱	冷漠,张冬玲
下辈子不做女人	陈瑞
地心	单冲峰
你的样子	罗大佑
喀什噶尔胡杨	刀郎
夕阳之歌	梅艳芳
黄金甲	周杰伦
着魔	张杰
天竺少女	李玲玉
Lights Up	方大同
小妹听我说	金久哲
御龙镜中隐	汪苏泷
分手快乐	梁静茹
爱是一颗幸福的子弹	汪峰
Jeanny 珍妮	罗百吉
小小水仙花	小蓓蕾组合
Un Ange Frappe A Ma Porte	Natasha St-Pier
相见不如怀念	那英
掉了	张惠妹
六月的雨	胡歌
雨水一盒	陈绮贞
车站	曹磊
卑微的荣耀	张恒远
云河	邓丽君
让世界为你转身	张玮
你那么爱她	李圣杰,林隆璇
战友还记得吗	小曾
不懂自己	Karey天天
梦中的额吉	乌达木
我终于失去了你	赵传,红十字合唱团
不只是情人	张睿,莫龙丹
Rain Over Me	Pitbull
爱很简单	陶喆
Fantastic (迷幻)	Henry
万泉河水清又清	玖月奇迹
多一个人陪伴	东来东往
Can't Remember To Forget You	Shakira,Rihanna
跟着感觉走	苏芮,张惠妹
你在我心里	邓丽君
爱着爱着就永远	田馥甄
小白兔请客	小蓓蕾组合
天使的翅膀	徐誉滕
草原的月亮	云飞
不要对我说无所谓	祁隆
微博控	许嵩
Wonderful	BigBang
最后一次	孙露
逐梦令	李玉刚
Somebody That I Used To Know	Gotye
曾经心痛	叶倩文
擦肩而过	郑源
三国恋	Tank
回心转意	黑龙
回家 - 萨克斯	轻音乐
犯错	斯琴高丽
你走后	杨坤
昆明湖	后弦
钟无艳	谢安琪
最幸福的人	曾春年
因为爱情 (京剧版)	霍尊
吉祥的酥油灯	降央卓玛
生日快乐	儿童合唱团
老爸老妈	阿宝
爱我别走	张震岳
唯一	王力宏
咕叽咕叽	孙燕姿
失踪	林忆莲
海阔天空	Beyond
挪威的森林	伍佰
英雄泪	王杰
历史的天空	毛阿敏
花太香	任贤齐
伤心1999	王杰
Don'T Cry	Guns N' Roses
Thunder	EXO-K
Barbie Girl	Aqua
我恨我痴心	刘德华
大朋友小朋友	蘑菇兄弟
天生一对	郭采洁
偏偏喜欢你	陈百强
答应不爱你	郑中基
我爱你中国	平安
心心锁	爱戴
当	动力火车
被遗忘的时光	蔡琴
梦	尚雯婕
滴答	侃侃,李晨
都对也都错	张惠妹
算你狠	陈小春
执迷不悔 (国语版)	王菲
捉泥鳅	卓依婷
约定	光良
煎熬	李佳薇
让我一次爱个够 征服 哭不出来 存在	那英,庾澄庆,汪峰,张惠妹
Hey Jude	The Beatles
爱之舞	新七小福
我是不是该安静的走开	郭富城
你的眼神	林志炫
感知成长的神奇	孙俪
壮志在我胸	成龙
归来吧	陈慧娴
表白	萧亚轩
Snow 静静的雪	Bandari
BLUE	BIGBANG
咬住下唇 (아랫입술 물고)	Esna
笑看风云	郑少秋
葫芦娃	儿童歌曲
拥抱	五月天
光阴的故事	罗大佑
第一滴泪	动力火车
怪爱太天真	大左
爱的供养（新版）	杨幂
爱的思念	央金兰泽
淘汰	陈奕迅
时间都去哪儿了(现场版)	王铮亮
雨天	孙燕姿
吻别	张学友
为你我受冷风吹	梁静茹
亲爱的小孩	苏芮
驿动的心	姜育恒
红莲の弓矢	Linked Horizon
一天到晚游泳的鱼	张雨生
重来	邓鼓
黑色毛衣	周杰伦
The Phoenix	Fall Out Boy
故乡的云	费翔
Someone Like You	Angel Taylor
情非得已	庾澄庆
爸爸妈妈	王蓉
空谷幽兰	许巍
不朽	华晨宇
MILK	f(x)
你的每一次呼吸	水木年华
A、B、C字母歌	小蓓蕾组合
约定	周蕙
Far Away From Home	Groove Coverage
九九艳阳天	玖月奇迹
爸比宝贝	崔天琪,钟伟强
明天会更好	群星
从未这样心动过	祁隆
亲爱的路人	刘若英
不醉	黄渤
给所有知道我名字的人	羽泉
寂寞星球的玫瑰 The Rose	G.E.M.邓紫棋
一个人的圣诞节	张赫宣
I Got A Boy	少女时代
短发	梁咏琪
绝地	李祥祥
爱囚	庄心妍
不想长大	S.H.E
爱很简单	陶喆
最好的时代	凤凰传奇
神奇的九寨	容中尔甲
那一夜	谢军
我不后悔	郑源
你的所有瞬间（너의 모든 순간）	成诗京
一路歌唱	阿宝,张冬玲
外婆的澎湖湾	潘安邦
Part Of Me	Katy Perry
你来的声音 (中文版)	朴施厚
心肝宝贝	任贤齐,徐熙媛
梦想起航	TFBOYS
Fly Away	梁静茹
站台	DJ小可
Bleeding Love	萱萱
金达莱花	网络歌手
老男孩	筷子兄弟,刘忻
一定要爱你	田一龙
龙的传人	王力宏
我们的纪念	李雅微
The Cup of Life 	Ricky Martin
相约九八	王菲,那英
夜曲	周杰伦
骄傲的大公鸡	小蓓蕾组合
美丽中国梦	王芳
给自己的歌	李宗盛
香水有毒	胡杨林
傻子	林宥嘉
南无阿弥陀佛	李娜
춤을 춘다 (Midnight Blues)	Super Junior
红豆	方大同
没死掉就很好	单色凌
最美中国梦	正月十五
咪咪小花猫	小蓓蕾组合
身骑白马	徐佳莹
爱情伤了你爱情害了我	大庆小芳
菊花台	周杰伦
野马之梦	刘明辉
Viva La Vida	Coldplay
最后的倾诉	韩磊
断点(国)	张敬轩
QQ爱	王麟
修炼爱情	林俊杰
问道情	回音哥
半壶纱	NULL
谢谢你的爱1999	谢霆锋
直到世界的尽头	群星
奇迹世界	凤凰传奇
山不转水转	那英
当你老了	赵照
Count Your Last Blessings	Sum 41
说爱你	蔡依林
卷珠帘 (feat. 费玉清)(live版)	霍尊
Moongate	Secret Garden
卡农钢琴曲（Variations on the Canon）	我的野蛮女友
因为爱情来得不容易	张杰
If I Were A Boy	Beyonce
错的人	萧亚轩
黄玫瑰	刀郎
好了伤疤忘了疼	大庆小芳
七月七日晴	许慧欣
友情岁月	郑伊健
Baby, Don't Cry	EXO-M
狼与美女 (EXO 中文版)	EXO
该死的温柔	马天宇,斯琴高丽
爱拼才会赢	卓依婷,林正桦
渔舟唱晚	古筝
巷雨	回音哥
你会爱我到什么时候	郑东
再见陌生人	罗志祥
Yesterday Once More	Carpenters
后会无期 (Live)	张碧晨
All By Myself	姚贝娜
伤痕	林忆莲
刘哈哈与大先生	刘心,大鹏
亲爱的你怎么不在身边	江美琪
Fly Me To The Moon	小野丽莎
情深谊长	韩红
听妈妈的话	周杰伦
春天的故事	董文华
悲伤的李白	徐良
种一棵小树	小蓓蕾组合
那片海	NULL
黑暗之光	雷光夏
风继续吹	张国荣
抹去泪水	韩宝仪
恋爱Ing	五月天
在那桃花盛开的地方	蒋大为
越单纯越幸福	王筝
沉默是金	张国荣
回不去的甜	小贱
再见理想	Beyond
3 - 指挥战歌	德国战车
初爱	杨宗纬
让泪化作相思雨	南合文斗
你是我心爱的姑娘	张赫宣
I Love You	王若琳
梦中新娘	祁隆
淘汰	陈奕迅
第一滴泪	倪鹏
九九艳阳天	刀郎,黄灿
篱笆墙的影子	阿宝
就这样成为你的回忆	冷漠
中国人	刘德华
为谁憔悴	DJ小可
NoNoNo	Apink
Defeated	Anastacia
大悲咒	龚玥
画心	张靓颖
爱什么稀罕	刘雅婷,张欣奕
We Are The Champions	Queen
幻听	许嵩
Trespassing	Adam Lambert
Swing (嘶吼)	Super Junior-M
好爸爸坏爸爸	儿歌
Wish You Were Here	Avril Lavigne
铁窗泪	迟志强,张秀艳
不解释亲吻	萧亚轩
我想我能勇敢一点	曾雨轩
Bye Bye Bye	Lovestoned
父亲的草原母亲的河	乌兰托娅
望月	宋祖英
我真的好难过	张嘉洵
小苹果	回音哥
세렌디피티(情缘)	(2Young)
我是一棵小小草	小蓓蕾组合
鸿雁（原唱：呼斯楞）	沙宝亮
成全	刘若英
偶像万万岁	TimeZ组合
Song From A Secret Garden	Secret Garden
忘忧草	周华健
咸鱼	五月天
Cry.	Mariah Carey
Party Rock Anthem	LMFAO
第一夫人	张杰
错误的爱	韩宝仪
Top Of The World	Carpenters
像中枪一样(총 맞은 것처럼)	白智英
你是我的眼	萧煌奇
四季圈	陈奕迅
Holy Virgin (Extended Mix)	Groove Coverage
回家乡	羽泉
国歌	合唱
Big Big World	Emilia
别用下辈子安慰我	陈瑞
热情	田馥甄
萍聚	卓依婷
英文版 - yesteday once more	昨日重现
海浪	黄品源
狂流	羽泉
我为你歌唱	曲婉婷
今生缘	旭日阳刚
Price Tag	B.o.B,Jessie J
一段情歌一段伤	龙梅子
你把我灌醉	黄大炜
宝贝 (In A Day)	张悬
舍不得	弦子
潮湿的心	卓依婷
三人游	方大同
坐在巷口的那对男女	自然卷
Until You	Shayne Ward
世界第一等	伍佰,china blue
没有理想的人不伤心	新裤子
我要给你	庾澄庆,蘑菇兄弟,金润吉,葛泓语,苏梦玫
千年之恋	飞儿乐团
What Doesn'T Kill You (Stronger)	Kelly Clarkson
青青河边草	高胜美
我是不是你最疼爱的人	潘越云
爱过不后悔	郑源
We Are The World	Michael Jackson
味道	辛晓琪
吻得太逼真	张敬轩
飞鸟的记忆	邱小龙
兄弟干杯	庞龙,李永波
潇潇雨未歇	周华健,苏慧伦
一辈子朋友	杨坤,张靓颖
做我老婆好不好	DJ小可
I Want It That Way	Backstreet Boys
约定 (약속)	金秀贤
Sound Of Silence	Ania
我要快乐	张惠妹
十送红军	龚玥
放狠爱	慕容晓晓,肖玄
我爱你	叶秉桓
美丽的草原我的家	德德玛
西厢	后弦
祝福你亲爱的	筷子兄弟
\x-$\x/#\x-#\x, \x.#\x-0\x-/\x/ \x-/\x0!\x.	吴贞
Hands On The Radio	Chris Garneau
Monica	张国荣
爱之初体验	张震岳
惜别	石进
All Night	f(x)
数鸭子	少儿歌曲
心要痛到什么时候	龙梅子
明天不上班	谢帝,蔡健雅
等你爱我	陈明
一生所爱	舒淇
夜的钢琴曲(五)	纯音乐
离爱不远	朱克
经过	陈楚生,何洁
藕断丝连	陈瑞
一万次悲伤	逃跑计划
少年游	任贤齐
如果当时	许嵩
时间都去哪了 - 2014元宵春晚大萌子王铮亮合唱	大萌子,王铮亮
爱的箴言	朱克
眼泪	余俊逸
离不开你	陈小春
说谎	张信哲
奔跑	羽泉
情歌	梁静茹
醉清风	弦子
每天爱你多一些	张学友
流恋	吴奇隆,严艺丹
多喜欢你	小贱
아픈 사랑	李敏镐
爱丫爱丫	By2
电台情歌	莫文蔚
春天在哪里	小蓓蕾组合
爱如潮水	张信哲
Take Me Home, Country Roads	塔斯肯
天下无双	张靓颖
爱的世界只有你	祁隆
Applause	Lady Gaga
天堂	腾格尔
饿狼传说	张学友
晚秋	毛宁
她	马上又
温柔的慈悲	阿桑
爱我还是他	陶喆
简单的事	李代沫
California Gurls	Katy Perry,Snoop Dogg
对你爱不完	郭富城
万物生 (梵文)	萨顶顶
一万个舍不得(DJAlex.x Mix Version)	庄心妍,祁隆
不了情	邓丽君
承认	曲婉婷
少女的祈祷	杨千嬅
米兰的小铁匠	周杰伦
快乐崇拜	潘玮柏,张韶涵
人海情缘	龙梅子,陈少华
金箍棒	龚琳娜
放下	胡夏
Story	朴信惠
明明爱你	林凡
画	赵雷
外面的世界	齐秦
请你继续爱我	周艳泓,金润吉
当爱已成往事	范玮琪,丁于
挪威的森林	伍佰
剪爱	张惠妹
阿飞的小蝴蝶	萧敬腾
大约在冬季	齐秦
Dying In The Sun	The Cranberries
何日君再来	邓丽君
值得	郑秀文
冷雨夜	Beyond
Hey Jude	孙燕姿
人质	杨宗纬
Until It's Gone	Linkin Park
写不完的温柔	邓紫棋
痛哭的人	伍佰
渴	孙燕姿
要死一定要死在你手里 (Live)	莫西子诗
分手后还是朋友	高安
记得	林俊杰
等一个他	G.E.M.邓紫棋
心驰神往	凤凰传奇
暗香	林海
Wake Me Up	Avicii
情定日落桥	张洪量
再度重相逢	伍佰
雪	杜雯媞,王艺翔
惜别的海岸	龙飘飘
神武雨霖铃	阿悄
一首心歌	吉克隽逸
你懂不懂爱	唐古
情难忘意难忘	甲子慧
16.不	陈百强
My Turn To Cry(爱离开)	EXO
慢摇舞曲	DJ舞曲,欧美经典
我们都被忘了	谢安琪
Palace Memories	神思者
You'Re Beautiful	James Blunt
第七感	张靓颖
当年情	张国荣
她	王思远
我们不是说好了吗	白百何,彭于晏
金玉良缘(电视剧《金玉良缘》主题曲)	李琦
黄玫瑰	孙露
叶子	阿桑
你怎么舍得我难过	黄品源
一起来	黄绮珊
浅唱	许嵩,Dior
心经	印能法师
不潮不用花钱	林俊杰
滚滚长江东逝水	杨洪基
离人（声动亚洲）	霍尊
今生无缘来生再聚	曹越,门丽
Smile	Avril Lavigne
胡琴情缘	大庆小芳
Cry On My Shoulder	Deutschland sucht den Superstar
怎么说我不爱你	萧敬腾,唐一嘉
小草	小蓓蕾组合
Magic	Coldplay
睫毛弯弯	王心凌
被伤过的心还可以爱谁	六哲
男人海洋	周传雄
时间里的花	魏雪漫
壮志在我胸	成龙
Making Love Out Of Nothing At All	林志炫
玻璃	蔡淳佳
假行僧	崔健
千里之外	费玉清
孤单北半球	梁静茹
Gwiyomi song	Hari
天越蓝我就越想你	乌兰图雅
怀念战友	刀郎
凤凰展翅	凤凰传奇
有一种爱叫做放手	阿木
烟花三月	龚玥
相思引	董贞
走西口	谭晶
九佰九拾九朵玫瑰	邰正宵
好胆你就来	叶玮庭
超级爆	张欣奕
欢颜	齐豫
最冷一天	陈奕迅
童真年代	张学友
约定	陈奕迅
Cold As You	Taylor Swift
在路上	刘欢
走样	张宇
跟往事干杯	孟鹏,塔斯肯
啦啦啦	淑熙
夜太黑	林忆莲
真的好想你	周冰倩
The Saltwater Room	Owl City
心酸	林宥嘉
Roly - Poly	T-ara
爱的独白 (Agape)	张力尹
小夜曲	胎教音乐
明天也要作伴	锦绣二重唱
魔鬼中的天使	崔天琪
安静下来	毕夏
解放	羽泉
心跳	王力宏
梦醒时分	陈淑桦
小白兔白又白	群星
伤心太平洋	任贤齐
且听风吟	朴树
命中注定	庾澄庆
有多少爱可以重来	迪克牛仔
You Are Not Alone	Michael Jackson
烟火	陈翔
爱的奴隶	崔子格
遥远的她	张学友
爱爱爱爱	王洪迪
启程	水木年华
鸟叔 - 绅士	鸟叔
你若盛开	玖月奇迹
草原舞曲（DJ版）	张冬玲,阿宝
走四方	韩磊
爱在西元前	周杰伦
白蛇爱情物语	金莎
钢琴独奏	天空之城
祝福	张学友
多余的解释	许嵩
My All	滨崎步
灰色轨迹	Beyond
邂逅	陈瑞
被风吹过的夏天	金莎,林俊杰
送别	刀郎
赛尔号	NULL
兰花花	阿宝
相爱很难	梅艳芳,张学友
我为你歌唱 When It’s Lonely	曲婉婷
月亮代表我的心	齐秦
梦醉西楼	陈瑞
错过了缘分错过了你DJ版	何龙雨
因为你爱上他	蒋雪儿
Susan说	陶喆
Bad Girl (坏女孩)	Henry,CHANYEOL (EXO)
东南西北风	卓依婷
流光飞舞	陈淑桦
画中仙	金莎
安妮的仙境	Bandari
花桥流水	高安,纳兰珠儿
小三续集	冷漠
英雄的黎明	纯音乐
献给爱丽丝	贝多芬
远方的寂静	林海
无限大	孙燕姿
丁香花	韩宝仪
失恋Style	丁丁
少年壮志不言愁	刘欢
One More Night	Maroon 5
亲爱的小孩	权振东
Cry Cry	T-ara
八连杀	NULL
Hush	miss A
花火	梁博
Take A Bow	Rihanna
飘摇	周迅
我爱你	王麟
别哭我最爱的人	郑智化
用心良苦	张宇
当时的月亮	王菲
红尘客栈 - 第二十届中歌榜现场版	周杰伦
再回首	姜育恒
火火的爱	蓝琪儿
I'M Sorry That The Kitchen Is On Fire	Tamas Wells
Say You, Say Me	Lionel Richie
山路十八弯	李琼
Price Tag	吴莫愁
沧海一声笑	许冠杰
Never Say Never	Justin Bieber
蝴蝶少女	EXO-M
别说我的眼泪你无所谓	东来东往
咱爸咱妈	龙梅子,老猫
疼爱	张卫健
The Way Of The Wind 微风吹拂的方式	Bandari
无言的结局	李茂山,林淑容
咖啡	张学友
Halo	Beyoncé
有你就很幸福	后弦
肝肠寸未断	青鸟飞鱼
温柔心愿	李易峰
梦的堡垒	蒋瑶嘉
Listen	Beyonce
无与伦比的美丽	苏打绿
梁祝	小提琴
粉红色的回忆	李玲玉
Summertime Sadness	Lana Del Rey
小兔子乖乖 - 把门开开	儿童歌曲
向往	李健
2013孤独的人是可耻的	张楚
欧若拉	张韶涵
弱水三千	周传雄
野百合也有春天	孟庭苇
自己	姚贝娜,林育群
我知道	By2
明明就	周杰伦
高地	汪峰
美	王力宏
万里长城永不倒	罗文
牡丹江	南拳妈妈
新长征路上的摇滚	崔健
Try To Remember	黎明
不愿错过你	陈艺搏
Jar Of Love	曲婉婷
等	郑源
死不了	任贤齐
你在哪里	张杰
红尘情歌	王夏
斯卡布罗集市	莎拉.布莱曼
敢问路在何方	蒋大为
玖月奇迹	玖月奇迹
现代爱情故事	张智霖,许秋怡
花好月圆夜	杨千桦,任贤齐
星光游乐园	Twins
Live Tomorrow	Laleh
九百九十九朵玫瑰	邰正宵
冬季到台北来看雨	孟庭苇
猜	斯琴高丽,顾峰
家乡	韩红
还是要幸福	田馥甄
爱的城堡	卓文萱
谁伴我闯荡	Beyond
New Divide	Linkin Park
他不准我哭	邓丽欣
随遇而安	黄沾
繁星点点	庄心妍
采蘑菇的小姑娘	小蓓蕾组合
别想她	高进
高山槐花开	凤凰传奇
幸福的两口子	庞龙
如果我是Dj 你还会爱我吗	王绎龙
最熟悉的陌生人	萧亚轩
卓玛	云飞
女人的选择	姜育恒
任我行	陈奕迅
情人	Beyond
夜上海	周璇
不怕不怕	郭美美
杜十娘	卓依婷
慢慢	王乃恩
What I'Ve Done	Linkin Park
情人	杜德伟
想定下来	关喆
英雄赞歌	彭丽媛
倔强	五月天
歌声与微笑	儿歌
爱情红绿灯	徐一鸣
时间都去哪了	NULL
阿娜尔罕	阿不都拉
The Art Of Letting Go	Mariah Carey
相思风雨中	张学友,汤宝如
Touch Love	尹美莱
你好毒	张学友
小小的太阳	孙露
我在人民广场吃炸鸡	阿肆
一吻天荒	胡歌
小薇	黄品源
I Wanna Rock	刘雅婷
醉梦仙霖	董贞
丁香花	唐磊
好运来	祖海
我们没有在一起	刘若英
心中的草原	乌兰图雅
证据	刘籽辰
为什么受伤的总是我	林志颖
我们不是相爱吗	T-ara
心湖雨又风	高胜美
HISTORY	EXO-M
某个心跳	本兮
卑微的荣耀	张恒远
全世界失眠	陈奕迅
幸福额度	苏打绿
22	Taylor Swift
不如不见	陈奕迅
孤单心事	蓝又时
爱是你我 - 小沈阳夫妻档歌曲	小沈阳,沈春阳
一千零一夜	邰正宵
踏浪	小蓓蕾组合
全世界宣布爱你	孙子涵,李潇潇
心经 - 梵唱 佛音梵歌经咒念诵念颂	佛教音乐
My Songs Know What You Did In The Dark (Light Em Up)	Fall Out Boy
爱的供养	何晟铭,杜淳
我的楼兰	云朵
普通朋友	陶喆
天籁之音 - 班得瑞 钢琴 好听的纯音乐	轻音乐
我的蒙古马	乌兰图雅
AINY 爱你	G.E.M.邓紫棋
无悔这一生	Beyond
孤枕难眠	周华健
我爱你	S.H.E
The Day You Went Away	M2M
有一点动心	张信哲,刘嘉玲
给我一首歌的时间	周杰伦
火柴天堂	熊天平
风中的承诺	李翊君
你把爱还给我	高安
情话	徐良
把悲伤留给自己	陈升
明天不上班	谢帝
正义之道	黄渤
Treasure	Bruno Mars
囚鸟	田馥甄
富士山下	陈奕迅
Holler	少女时代-太蒂徐
舒伯特小夜曲	纯音乐
Bye Bye Beautiful	Nightwish
认错	许嵩
No Matter What	Boyzone
A City Of Sadness	神思者
今世有缘	NULL
虫儿飞	郑伊健
Vision Of Love	Mariah Carey
小河淌水	龚琳娜
倾城	陈奕迅
玛吉阿米	央金拉姆
Oh Boy	G.E.M.邓紫棋
姐妹	张惠妹
Maybe I'Ll Go	Lene Marlin
你不再爱我	蔡妍
这一生最美的祝福	巫启贤
布拉格广场	蔡依林,周杰伦
蜻蜓	小蓓蕾组合
心太软	任贤齐
Waka Waka (This Time For Africa)	Shakira
千千阙歌	DJ小可
朋友	谭咏麟
时光机	五月天
鹿港小镇	彭佳慧
一翦梅	费玉清
乘客	王菲
老公亲亲我的嘴	刘羽
爱的代价	张艾嘉
看我72变	蔡依林
逆战	张杰
月半小夜曲 (Live)	陈乐基
午夜香吻	高胜美
红红的萨日朗	乌兰图雅
劫后余生	萧亚轩
最后一个情人	陈瑞
明明很爱你	品冠,梁静茹
掌心	无印良品
别问我是谁	王馨平
为爱停留	NULL
北京爱情	小柯
只要你过得比我好	蘑菇兄弟
爱情不值得我流泪	纪晓斌
心有独钟	陈晓东
By The Way	Red Hot Chili Peppers
我等到花儿也谢了	张学友
蝴蝶飞呀	小虎队
珍惜	孙露
真英雄	小沈阳
我想和你走下去	王铮亮
如果云知道	齐秦
My Love	田馥甄
小镇姑娘	陶喆
白鸽	伍佰
梦醒时分	伍佰
莉莉安	宋冬野
牧羊曲	郑绪岚
江湖笑	周华健,黄晓明,小虫
马上有钱	朱贝贝
勇敢一点	赵传
碎心石	谢军
GALAXY SUPERNOVA (PV FULL VER.)	少女时代
痛彻心扉	姜玉阳
惊鸿舞	姚贝娜
今夜无眠	周冰倩
兰亭序	周杰伦
I'm sorry	CNBLUE
你要的爱	戴佩妮
星月情缘	安东阳
Schnappi	Schnappi
秋风落叶	姜玉阳
有个傻瓜爱过你	唐古
剪爱	黄绮珊
不再犹豫	Beyond
圪梁梁	王二妮
我会好好的	王心凌
弯弯的月亮	刘欢
共同渡过	张国荣
The Star(星)	EXO
牧马人	杨坤,丁丁,平安,金志文,关喆
愚爱	欢子
我想更懂你	潘玮柏,苏芮
我只在乎你（声动亚洲）	霍尊
彩虹	叶蓓
给所有知道我的名字的人	赵传
Talk Dirty	Jason Derulo
映山红	玖月奇迹
说到爱	蔡健雅
家	许巍
心乱乱	崔子格
流着泪说分手	金志文
寂寞是你给的苦	NULL
Bye Bye Bye	N Sync
红尘有你	王杰
不再说分手	王菀之
悬崖	齐秦
心语(电视剧《舞乐传奇》主题曲)	韩红
姑娘我爱你	索朗扎西
月亮传奇	苏月
但愿人长久	邓丽君
珍惜	李宇春
我怀念的	萧敬腾
他的猫	徐良
蝴蝶 (나비)(Butterfly)	f(x)
看月亮爬上来	张杰
往事只能回味	韩宝仪
蓝色土耳其	周传雄
雨花石	李雨儿
那个男人	杨宗纬
Better Man	Robbie Williams
为你写诗	吴克群
花好月圆	刁寒
好不容易	张靓颖
铁齿铜牙纪晓岚	戴娆
潇洒的走	高胜美
垭口2014（feat. Steve Vai）	齐秦
不要怕	吉克隽逸
我不后悔	林志颖
Come Back Home	2NE1
燕子	彭丽媛
蜿蜒	品冠
我不是男神	张亮,张悦轩
Dj Got Us Fallin' In Love	Usher,Pitbull
Shirt (衬衫)	Super Junior
陪我看日出	蔡淳佳
北方的狼	齐秦
最远的你是我最近的爱	车继铃
那丝也有春天	大鹏
별에서 온 그대 (来自星星的你)	Younha
大艺术家	蔡依林
光辉岁月(国语版)	黄家驹
离别的眼泪	龙梅子
卷珠帘 (新编版Live)	霍尊
热血燃烧	郑伊健,陈小春
Love Of My Life 一生爱恋	Bandari
月亮可以代表我的心	杨坤
每一颗星辰	华晨宇,欧豪,白举纲,宁桓宇,于湉,张阳阳,饶威,左立,贾盛强,于朦胧,范世琦,居来提
秋殇别恋	格子兮
99次我爱他	元若蓝
不要再说你还爱我	冷漠
我也很想他	孙燕姿
小兔子乖乖	小蓓蕾组合
眼泪	The Daydream
真爱你的云	王铮亮
如果你是我的传说	刘德华
恒星	汪峰
消灾吉祥神咒	佛教音乐
爱很美	Sara,刘佳
思思念念全是你	高安
点亮未来	张靓颖,金秀贤,张杰,噶丽娅
You Belong With Me	Taylor Swift
天黑黑	邓鼓,余俊逸
小背篓	宋祖英
两个人	蔡妍
铁血丹心	罗文,甄妮
闪耀	杨宗纬
老男孩	羽泉
海阔天空	黄家驹
名媛	爱戴
他还是不懂	S.H.E
鬼迷心窍	李宗盛
放手	何龙雨,江宇涵
下辈子做你的女人	DJ小可
幸福时光	石进
晚风	伍佰
再痛都会记得你的好	王麟
山里红	祁隆
中华民谣	孙浩
昨夜星辰	龙飘飘
忘记时间	胡歌
枫	周杰伦
伤	项亚蕻,羽泉
傻傻的爱傻傻等待	贺一航
沧海一声笑	许冠杰
爱在深秋	谭咏麟
接新娘	皆大欢喜
难以启齿的柔弱	金志文
橘子香水	任贤齐
丑八怪	薛之谦
Business	Eminem
我明白	李宗盛,林忆莲
Lydia	飞儿乐团
Every Breath You Take	The Police
大花轿	火风
Back To December	Taylor Swift
Kelly	萧敬腾
猫叫 老鼠惨叫声	佚名
观世音菩萨发愿偈.大悲咒	齐豫
三百六十五里路	塔斯肯
归(兄弟)	龙井说唱
世外桃源	许巍
爱的主打歌	萧亚轩
最好听的钢琴曲	轻音乐,钢琴曲
喜欢寂寞	苏打绿
听说	刘若英
x-x/x!x./xx-x0x.x-(x-	乌兰托娅
青石的街道向晚	范宗沛
你的背包	陈奕迅
追梦人	高胜美
또 운다	文明真
Something	Girl's Day
好心分手	卢巧音
Girlfriend	Avril Lavigne
Hall Of Fame	The Script,will.i.am
我期待	张雨生
一个人的天荒地老	张宇
蜀绣	李宇春
极速	爱乐团
梦中的婚礼(MARIAGE D' AMOUR)	纯音乐
锦鲤抄	银临
情书	张学友
搁浅	周杰伦
风往北吹	孙楠
오늘 같은 눈물이 (像今天这样的眼泪)	许阁
预谋	代理仁
断桥离情	姚贝娜
牡丹之歌	蒋大为
半糖主义	S.H.E
走过咖啡屋	千百惠
你是我的眼	小臭臭
草原夜色美	德德玛
We Can't Stop	Miley Cyrus
明月千里寄相思	蔡琴
万万没想到	白客
坚持到底	阿杜
我想我是海	黄磊
爱你在心口难开	凤飞飞
我是真的爱你	张信哲
军港之夜	苏小明
未成年	本兮
东方红	王二妮
遇上你是我的缘	阿鲁阿卓
我恋爱了	张韶涵
爱不释手	李丽芬
光阴的故事	蘑菇兄弟
矛盾	田馥甄
忘不了曾经的你	高安,郭玲
七里香	周杰伦
天气先生 (iTunes Session)	方大同
为你等待	次仁央宗
Better Together	Jack Johnson
站台2010	杨坤
落叶归根	王力宏
土豪我们做朋友	王麟,Dj Alex.x
满·月已霜	NULL
为了谁	祖海,佟铁鑫
擦肩而过	宇桐非
Story	朴信惠
我不会喜欢你	陈柏霖
走路去纽约	陶晶莹
我和草原有个约定	乌兰托娅
Dangerous	Michael Jackson
蜗牛的家(选自D大调哈夫纳小夜曲)	莫扎特
凤舞九天	DJ
嘟啊嘟啊	DJ
红尘笑我，我笑红尘	郑源,郑东
好想大声叫喜欢你	灌篮高手
葬花吟	龚玥
王铮亮 - 时间都去哪了	NULL
人在江湖漂	小沈阳
这样你还要爱我吗	张惠妹
美之见	蔡妍
大悲咒	龚玥
梦一场	那英
广岛之恋	张洪量,莫文蔚
女人们你们听好	MC天佑
十面埋伏	陈奕迅
我们结婚吧	金莎,刘佳
传奇	凤凰传奇
回来	梁博
可不可以不勇敢	范玮琪,曾静玟
爱情那么傻	品冠
一定要幸福	杨幂
浪子心声	许冠杰
妈咪妈咪	王绎龙
两只老虎	小蓓蕾组合
Forever Love	王力宏
求求你给点力	于玄子
在他乡	水木年华
花心传说	龙梅子,老猫
小燕子 - 儿歌大全	儿童歌曲
她来听我的演唱会	张学友
让我取暖	王力宏,彭羚
其实我很在乎你	谢容儿
雨的印记	伤感,背景音乐
差不多先生	Mc Hotdog
有你的快乐	王若琳
旅行	许巍
孤星泪	刘德华
原点	蔡健雅,孙燕姿
下定决心忘记你	大哲
独角戏	许茹芸
Better Me	薛凯琪
忘了我是谁	塔斯肯
阿里山的姑娘	玖月奇迹
分飞	徐怀钰
想你零点零一分	张靓颖
大哥	柯受良
火	张惠妹
摇篮曲	黑鸭子
草原一枝花	乌兰图雅
BACK SEAT	JYJ
一个人的精彩	萧亚轩
当爱已成往事	张国荣
祈祷	王杰,王韵婵
蒙古新娘	乌兰托娅
爱在深秋	谭咏麟
忠孝东路走九遍	动力火车
潇湘雨	胡彦斌
无赖	郑中基
黑暗中的舞者(蒙语)	代青塔娜
Any Man Of Mine	Shania Twain
真实	张惠妹
唤醒时空	羽泉
Telephone	Lady Gaga
中国山	钟汉良
男儿当自强	成龙
一个人生活	林凡
只得一生	罗大佑
旧日足迹	Beyond
大悲咒	索南仁波切
大地	羽泉
Ballade No.2 In B Minor 第二号叙事曲	Maksim
你的眼神	蔡琴
姑娘我爱你	降央卓玛
够爱	东城卫,a Chord
违章动物	许嵩
原谅我一次	欢子
哥哥妹妹	门丽,胡小宝
何日君再来	邓丽君
Heart And Soul	Kenny G
彩虹	周杰伦
独一无二	李贞贤
他和她	回音哥
把握	姚贝娜
真心真意过一生	叶倩文
都怪我	刘德华
谁在意我流下的泪	蒋雪儿
Fear Not This Night	吉克隽逸
三天三夜	刘雅婷
Get Lucky	Daft Punk,Pharrell Williams
I Love You	Just
我在这	张杰
幸福不是情歌	刘若英
口是心非	萧敬腾,唐一嘉
Beyond The Game	游戏原声
大约在冬季	齐秦
回家的路	曾一鸣,尹熙水,金贵晟
迷宫	王若琳
Dreaming In The Moonlight 梦于月光中	Bandari
我相信	吴莫愁
Moonlight Shadow	Dana Winner
행복 (Happiness)	Red Velvet
真的好想你	费玉清
秋天的玫瑰	陈瑞
伤	项亚蕻
星语心愿	张柏芝
董小姐	宋冬野
抽身	冷漠,王雅洁
除了你	韩宝仪
感谢妈妈	高安,乌兰托娅
玛尼情歌	上官红燕
圆梦	平安
彩虹背后	海鸣威
鸿雁	范海荣
贼拉拉的爱你	谢丹
勇敢	张惠妹
鸟人	乌拉多恩
爱你一万年	韩宝仪
星空	五月天
和你一样	李宇春
我的心太乱	周传雄
女人不需要性感不是骚	DJ,网络歌手,MC
西瓜太郎	DJ小可
军中绿花	龚玥
Can You Feel The Love Tonight	Elton John
我们的纪念日	范玮琪
我爱你塞北的雪	降央卓玛
年轻的战场	张杰
暧昧	王菲
别在伤口洒盐	张惠妹
不醉不会	田馥甄
矜持	杨宗纬
风吹麦浪	叶一茜
红玫瑰DJ版	大哲
烛光里的妈妈	毛阿敏
蝶儿蝶儿满天飞	高胜美
爱如潮水	张信哲
漫步人生路(粤)	邓丽君
斯德哥尔摩情人	陈奕迅
相亲相爱	孙楠,张惠妹,陈慧琳,古卓文
渡情	左宏元,张慧清
再不疯狂我们就老了	李宇春
拿出你的情，抓住你的爱	皆大欢喜
阿弥陀佛	白玛多吉
为你我受冷风吹	林忆莲
好男人	张镐哲
Right Here Waiting	Richard Marx
我爱他	丁当
爱你	G.E.M. 邓紫棋
爱上一个不回家的人	林忆莲
你还记得吗	权振东
Tell Me Why	Declan Galbraith,The Young Voices Choir
回家	王杰
烟花易冷 (京剧版)	霍尊
当你孤单你会想起谁	张栋梁
喂喂	周笔畅
梦醒时分	陈淑桦
一生何求	陈百强
山沟沟	金志文
太多Ii	陈冠蒲
吉祥如意	凤凰传奇
Keep Walking or I'll Kill You	Agnes Kain
我爱的人	林宥嘉
天天想你	张雨生
千年泪	董贞
The Truth That You Leave	pianoboy
兰花草	卓依婷
杀手	林俊杰
What Are Words	Chris Medina
时间长了受不了	庄心妍
你是我的玫瑰花	庞龙
你是我今生最爱的女孩	孙露
听说爱情回来过	杨宗纬
邻家美眉	王绎龙
Only One	宝儿
不值得	梦飞船
懂事	侯磊
Face The Sun	James Blunt
恍若如梦(新曲)	石进
纸心脏 (종이 심장)(Paper Heart)	f(x)
如果缘只到遇见	严艺丹
一起走过的日子	刘德华
What Have U Done	G.E.M.邓紫棋
雪人	张玮
The Rose	Westlife
我是我的	张靓颖
别怕我伤心	张信哲
其实我还好	俞灏明
Lemon Tree	Fool S Garden
幸福万年长	汤灿
Run	EXO-K
爱与不爱	韩晶
狮子座	曾轶可
星星	Vitas
矜持	王菲
窗外	李琛
杨坤-空城	NULL
骨子里的我	李代沫
疯狂爱爱爱	慕容晓晓,办桌二人组
那年夏天宁静的海	王心凌
正在输入	单小源
给我你的爱	张杰,林宥嘉
假行僧	张赫宣
阳光照进回忆里	逃跑计划
In The End (Album Version)	Linkin Park
美了美了	汤潮
爱的代价	李宗盛
无尽的爱	成龙,金喜善
受了点伤	阿桑
We Are Electric	Flying Steps
伤了你的心的我伤心	孟庭苇
从头再来	刘欢
送别	小蓓蕾组合
迟来的爱	李茂山
夜来香	邓丽君
渡情	高胜美,左宏元
忘情水	刘德华
想自由	林宥嘉
Hot  Summer	f(x)
做你的男人	张信哲
What A Wonderful World	Louis Armstrong
我有一段情	罗百吉
当时的月亮	侯磊,丁克森
再见(안녕)	孝琳(Sistar)
尘埃	魏晨
별처럼	K.Will
火烧的寂寞	信
月弯弯	李炜
黑白配	范玮琪
天空之城	游学志
预谋 - 许佳慧  cash djmcq remix 女club	DJ
你来的声音 (韩文版)	朴施厚
会过去的	梁静茹
Sunshine Girl	moumoon
蜗牛	小蓓蕾组合
放歌大草原	乌兰托娅
万花瞳	蔡依林
奔跑	黄征,羽泉
你若安好 便是晴天	杨钰莹
摩天轮	罗百吉,宝贝
画(live版)	赵雷
机器灵 砍菜刀	张卫
献给爱丽丝	理查德·克莱德曼
Lemon Tree	王若琳
First Love	宇多田光
i remember the	颜培珊
卡萨布兰卡	英文经典老歌
The Best	苏梦玫
喜帖街	谢安琪
Love Love Love	EXO-K
好聚好散	郑源
飘雪	韩雪
I Wanna Be With You	Backstreet Boys
Loved Me Back To Life	Céline Dion
雨葵	石进
等待	韩磊
多情伤离别	高安,司徒兰芳
味道	张学友
我们说好的	张靓颖
Venus	孙燕姿
青藏高原	韩红
As I Moved On	Blue Foundation
风再起时	张国荣
康美之恋	谭晶
战放	本兮
当兵的历史	谭晶
Making Love Out Of Nothing At All	Air Supply
爱的箴言	邓丽君
不要对他说	张信哲
老子明天不上班	佚名
了结	董贞
最后一次	薛晓枫
Dreaming	金秀贤
随心所欲	罗琦
阳光下的我们	曲婉婷
把根留住	童安格
重来	黄小琥
泥人情歌	韩岚,薛晓枫
生日快乐	卓依婷
第一天	孙燕姿,五月天
你瞒我瞒	陈柏宇
眼泪	张学友
往事只能回味	龙飘飘
Love The Way You Lie (Part Ii)	Rihanna,Eminem
空白格	蔡健雅
等待	黄绮珊
你偷走了我的心	祁隆
铁血丹心	罗文,甄妮
浪子心声	刘德华
你的眼睛背叛你的心	郑中基
征服	那英,梁博,张玮,多亮,张赫宣
New Divide	Linkin Park
彩云追月	龚玥
爱在记忆中找你	林峯
Luv Letter	DJ OKAWARI
最美的歌儿唱给妈妈	蒋大为
Give You What You Like	Avril Lavigne
波斯猫	S.H.E
她的背影	王杰
Nightingale	Yanni
Ein kleines Lied	candee
刺心	常艾非
唱着情歌流着泪 DJ版	祁隆
一眼万年	林俊杰
你的眼神	蔡琴
原来的我	齐秦
最好的未来	刘若英
有点甜	NULL
张三的歌	蘑菇兄弟
有空你就来听听我唱歌	群星
Do You Want to Build a Snowman	Kristen Bell,Agatha Lee Monn
那么骄傲	金海心
愚人快乐	陈奕迅
家家 - 尘埃 - 步步惊情 片尾曲	NULL
三妻四妾	王媛渊
存在	单冲峰
草原情郎	朱贝贝
你还要我怎样	薛之谦
Wrapped In Red	Kelly Clarkson
我爱你胜过你爱我	杨小曼,冷漠
我是一只小小鸟	李宗盛
你太猖狂	田馥甄
靠近	罗震环
串烧dj	任军太
叩叩	李玟
성장통2	Cold Cherry
请到草原来	呼斯楞
太囧	楚博仁,王麟
你的柔情我永远不懂	陈琳
莫斯科没有眼泪	Twins
爱爱爱	颜小健
坏孩子的天空	纯音乐
向阳花	安与骑兵
太傻	巫启贤
喜欢两个人	彭佳慧
曾经最美	朱铭捷
珍惜	苏有朋
Mad World	Adam Lambert
套马杆	乌兰图雅,乌日娜
错过了缘分错过了你	冷漠
斗战神(游戏《斗战神》同名主题曲)	陈奕迅
谁的眼泪在飞	孟庭苇
All Over Again	Ronan Keating
你会爱我到什么时候	陶钰玉
同桌的你	刘若英
Like The Wind (日剧《爱情白皮书》配乐)	神思者
孟婆的碗	魏佳艺
첫 사랑니 (Rum Pum Pum Pum)	f(x)
你在烦恼什么	苏打绿
想念真好	汪峰
掌纹	曹格
So Far	Chris Garneau
千里之外 (京剧版)	霍尊
没那么简单	金志文
Can’t Stop	CNBLUE
巴黎夜雨	孙子涵
妈妈的吻	杨钰莹
小河淌水	皆大欢喜
Royals	Lorde
裸爱(江南style中文版)	张可儿
时间都去哪儿了	赵萌萌,王铮亮
预谋dj皮卡丘可爱版	佚名
信	周子琰
感谢相识	可歆,常定晨
Mr. Worldwide (Intro)	Pitbull,Vein
故乡	帕尔哈提;王卓
好好说再见	陶喆,关诗敏
Opera 2	Vitas
跟着你到天边	常石磊
外面的世界	齐秦
是不是这样的夜晚你才会这样的想起我	张智成
开学第一课	TFBOYS
黑蝙蝠中队	刘德华
我爱你你却爱着他	黑龙
Bye Bye	Mariah Carey
斑马斑马	宋冬野
踏古	林海
Easy Come Easy Go	蔡健雅,MC Hotdog
Mother	久石让
谁动了我的琴弦	周笔畅
桃花运	杨钰莹
老爹	迪克牛仔,弦子
爱是一颗幸福的子弹	那英
栀子花开	何炅
看得最远的地方	张韶涵
爱我你就抱抱我	林妙可
一个人生活	吴莫愁
热带雨林	S.H.E
每一步	徐小凤
Murder My Heart	Michael Bolton
Right Now	Rihanna
分手快乐	梁静茹
指望	郁可唯
我选择笑	信
黄种人	谢霆锋
拥抱的理由(电视剧《因为爱情有多美》主题曲)	李泰
The Final Countdown	Europe
宝贝对不起	草蜢
倾国倾城	熊汝霖,阿宝
Europa (유로파）	少女时代
我爱你	王菲
我心永恒	群星
相爱分开都是罪	六哲
无奈的思绪	韩宝仪
南飞雁	李玉刚
死了都要爱	信乐团
厨师之歌	李志洲
被驯服的象	蔡健雅
Inside	Bang Gang
不再犹豫	黄家驹
被情伤过的女人	黑龙
夜空中最亮的星	逃跑计划乐队
流浪歌	陈星
只愿得一人心	NULL
生日礼物	江涛
丝萝	李宇春
雪山盟	罗百吉
女驸马	韩再芬
风云决	任贤齐
家在东北	庞龙
梦中的婚礼	贵族乐团
地心	汪峰
恶人	孙子涵,Xun
逆光	孙燕姿
明明白白我的心	李宗盛,梁静茹
冷酷到底	羽泉
mimimi	NULL
少先队队歌	儿童歌曲
铃儿响叮当	小蓓蕾组合
城府	许嵩
醉美天下	凤凰传奇
眉飞色舞	郑秀文
只爱你一个人	任贤齐
Everything In The World	曲婉婷
杀破狼	JS
Without You	Mariah Carey
天黑黑	孙燕姿
同桌的你 (风行版)	老狼
Glad You Came	The Wanted
Payphone	Maroon 5,Wiz Khalifa
剪爱	张惠妹
i no ri	西村由纪江
Love Is…	朴章贤,
经过	何洁,陈楚生
越来越好	宋祖英
Tonight, I Feel Close To You	孙燕姿,仓木麻衣
天黑	阿杜
今宵多珍重	陈百强
美丽的神话Ⅰ	成龙,金喜善
她说 (Live)	张碧晨
贝加尔湖畔 (Live)	李维;周深
喜欢两个人	彭佳慧
Breathless	Shayne Ward
Tonight I Wanna Cry	Keith Urban
我要去西藏	乌兰图雅
酒歌	乌兰图雅
问情	蔡幸娟
解脱	吴莫愁
亲吻祖国	王丽达
沙滩	苏梦玫
Return To Innocence	Enigma
千百年后谁又记得谁	韩磊
亲密爱人	王若琳
千本樱	初音未来
彩虹	羽泉
嫂子颂	李娜
妥协	蔡依林
再见 我的爱人	邓丽君
Lose Yourself	Eminem
你是我的唯一	郑源,陶钰玉
Take Me Home, Country Roads	John Denver
我的兄弟	汤潮
Let's Start From Here	王若琳
如果爱	张学友
映山红	黄英
春江花月夜	纯音乐
恋爱达人	罗志祥,徐熙娣
老地方	任贤齐
同手同脚	温岚
梦中的妈妈	云飞
霸王别姬	屠洪刚
北京欢迎你	群星
运动员进行曲	中国人民解放军军乐团
净土	孙楠
千言万语	邓丽君
相亲相爱的一家人	励志歌曲,星
九妹	黄鹤翔
如果真的不再爱我	祝兰兰
小小新娘花	孙露
你的爱太贵	张晓琥
梅花三弄	姜育恒
最长的电影_周杰伦	NULL
明明白白我的心	成龙,陈淑桦
化蝶	龚玥
音乐瞬间	舒伯特
Stay With Me	Sam Smith
梦里水乡	龚玥
卓玛	容中尔甲
美丽女人	刘嘉亮
Animals	Maroon 5
那么爱你为什么	黄品源,莫文蔚
轮回之境	CRITTY
当年情	王若琳
啦啦啦德玛西亚	音频怪物
雪域情歌	阿斯根
街角的祝福	戴佩妮
你究竟有几个好妹妹	孟庭苇
想亲亲想在心眼眼上	阿宝
Bad Boy	张惠妹
The Promise	Secret Garden
风起天阑	河图
记事本	周传雄
拥抱的理由	尹熙水
Buttons	The Pussycat Dolls
不管有多苦	那英
别碰我的人	陈小春
Demons	Imagine Dragons
用情	张信哲
挚爱	林志颖
Footprints In The Sand	Leona Lewis
Till The World Ends	Britney Spears
爱上你	S.H.E
玩笑	刘瑞琦
妙手空空	成龙,周华健,张震岳
土耳其进行曲	胎教音乐
夜空中最亮的星	
顺其自然	黄小琥
我爱你中国	梁博
站在高岗上	张惠妹
华胥引	河图
我的中国心	张明敏
屋顶	温岚,周杰伦
International Love	Pitbull,Chris Brown
鲁冰花	小蓓蕾组合
爱上张无忌	毛阿敏
蓝色理想	老狼
Blurred Lines	Robin Thicke,Pharrell,T.I.
太早	刘允乐
かざぐるま	一青窈
南屏晚钟	费玉清
姑苏台	张煜枫
征服	那英
Sexy Bitch	David Guetta,Akon
爱疯舞	崔子格
求佛	誓言
孤独啊	CNBLUE
Liekkas	Sofia Jannok
伤心的站台	安东阳
父亲	阎维文
拥抱着你的滋味	Free Party
呜咽 (울컥)	郑秀晶
无悔这一生	Beyond
分开不一定分手	山野
下雨时你会想起谁	石进
伤心的人别听慢歌	五月天
采莲	姚贝娜
女驸马	经典老歌
单恋一枝花	张宇
流浪者之歌	陈绮贞
你	屠洪刚
中国功夫	屠洪刚
看透爱情看透你	云菲菲,冷漠
烟花易冷 - 伽蓝雨 钢琴版 gaius	周杰伦
Everything At Once	Lenka
如果我变成回忆	Tank
快乐送	吴莫愁,庾澄庆,艾菲,黄晓明
草原之恋	乌兰托娅
死性不改	Twins,boy'z
老鼠爱大米	杨臣刚
离开地球表面	五月天
Boom Clap	Charli XCX
花火	梁咏琪
最初的信仰	沙宝亮
追风少年	吴奇隆
灯塔	丁丁
我是愤怒	Beyond
今天	曲婉婷
你不是真正的快乐	G.E.M.邓紫棋
像星 (별처럼)	K.Will
读你	蔡琴
你说爱我又不爱我	金生水
Dreams Will Never Die	Isgaard
桃花朵朵开	阿牛
李香兰	张学友
我不配做你男朋友	张提
大地飞歌	宋祖英
散了吧	林志炫
让一切随风	钟镇涛
可惜不是你	曹轩宾
Try	P!nk
冲动的惩罚	刀郎
我懂了	金莎
如果没有他你还爱我吗	六哲
大约在冬季	齐秦
月亮代表我的心	邓丽君
时光倒流	汪峰
我要快乐	曾一鸣
映山红	宋祖英
出埃及记	Maksim
死皮赖脸	阿悄
蓝色的蒙古高原	降央卓玛
雨花石 - 魔喉石头 amp	李玉刚,石头
乱世巨星	陈小春
祝我生日快乐	温岚
张三的歌	蔡琴
草原之夜	降央卓玛
野花	田震
无情的雨无情的你	樊桐舟
安静了	S.H.E
万物生	萨顶顶
我是你的谁	张含韵
爱，燃烧(电视剧《千金归来》片尾曲)	王铮亮
Oh!	少女时代
分手在那个秋天	DJ小可
高原红	央金
开不了口	周杰伦
外滩十八号	袁成杰,戚薇
Only U	少女时代-太蒂徐
最接近天堂的地方	张杰
Knockin  On Heaven S Door	Avril Lavigne
冰糖葫芦	冯晓泉
If Only You	Danny Saucedo
爱你一万年	刘德华
Baby, I M Not Sure If This Is Love	Club 8
Nothing'S Gonna Change My Love For You	方大同
我的心太乱	周传雄
英文字母歌	小蓓蕾组合
爱因为在心中	王力宏
咏春	七朵组合
串烧舞曲club 	ashao
我想结婚时	刘思涵
情花	本兮
直来直往	孙燕姿
原来我是巨蟹座	雷诺儿
于谦 - 弄死你 巡演大连	郭德纲
Mr.Chu	Apink
快乐至上	林志颖
下一次爱情来的时候	蔡健雅
原来你从来没有爱过我	唐古
元芳你怎么看DJ版	冷漠,赵小兵
Forever Love（声动亚洲）	茜拉
诀别诗	胡彦斌
情深深雨蒙蒙	赵薇
삐딱하게	G-Dragon
约定	周蕙
Scarborough Fair	Sarah Brightman
光辉岁月	Beyond
自由的奔跑	蘑菇兄弟
我的祖国	韩红
传奇（声动亚洲）	霍尊
旅行	唐荭菲
亲亲我的宝贝	周华健
Say It Right	Nelly Furtado
送亲歌	乌兰图雅
别怕我伤心	张信哲
Never Say Goodbye	Bon Jovi
知心爱人	付笛声,任静
绝不呼救	金志文
那些年我们一起追过的女孩	李行亮
Alien	Britney Spears
我们的爱	毅光年
Girl On Fire	Alicia Keys
一物降一物	门丽
浴火凤凰	黑鸭子
Mockingbird	Eminem
Everybody Hurts	Avril Lavigne
三轮车 - 谢小宇	MC
布达拉	央金兰泽
Do What U Want	Lady Gaga,R. Kelly
爱要怎么说出口	赵传
妻子	谭晶
下个转弯是你吗	杨丞琳
迟来的爱	李茂山
爱情这杯酒谁喝都得醉	闫旭,丁酉酉
梦醒了	那英
心愿	四个女生
Can'T Take My Eyes Off You	王若琳
一转身就是永远	许诺
血染的风采	梅艳芳
Complicated	Avril Lavigne
长城	Beyond
one for da money	overground
Hey Baby (Drop It To The Floor)	Pitbull
下辈子做你的女人	龙梅子
女骑士	徐良
天涯	爱乐团
风含情水含笑	杨钰莹
Billie Jean	Michael Jackson
我的中国梦	张明敏
不想离开	张栋梁
沧海一声笑	黄霑
落花流水	陈奕迅
花蝴蝶	蔡依林
Let Me Go	Avril Lavigne,Chad Kroeger
要抱抱	王蓉
傻傻男孩	吴欢
中国味道	凤凰传奇
等不到的爱	樊凡
Bad Boy	丁克森
我在贵州等你	张超（贵州）
我很忙	A-Lin
No Matter What	Boyzone
好男儿	小沈阳
把耳朵叫醒	金海心
I Hate Myself For Loving You	刘雅婷
再回到从前	张镐哲
大悲咒	黑鸭子
送别	古筝佛赞
星晴	周杰伦
心在跳	金池
Haru Haru	BigBang
Another Way To Die	Alicia Keys
情殇	信乐团
谢谢你的温柔	S.H.E,飞轮海
一生中最爱	谭咏麟
荷塘月色 街舞舞曲版	凤凰传奇
忘了你忘了我	王杰
如果不能好好爱 (心碎版)	吴克羣
Genie	少女时代
Forbidden Love (日剧《二千年之恋》配乐)	神思者
半面妆	爱乐团
等你等到我心痛	张学友
니가 뭔데 (Who You?)	G-Dragon
序-赵忠祥	龙梅子
月光水岸	Bandari
情路弯弯	龙梅子
Demons	Imagine Dragons
暗涌	王菲
我爱你	卢广仲
我去年买了个表	王麟
春天里	旭日阳刚
拥抱	五月天
隐形人	孙燕姿
내일은 없어	Trouble Maker
你怎么说	韩宝仪
文殊菩萨心咒	佛经
走西口	龚玥
相亲相爱	群星
心经	佛涯组合
北国之春	韩宝仪
花房姑娘	崔健
圣诞结	陈奕迅
笑脸	谢东
Don T Break My Heart	黑豹乐队
离别的车站	赵薇
旅途	汪峰
无言	张赫宣,卓义峰
春江花月夜	古筝
长相依	卓依婷
滴答	侃侃
梦千年之恋	金莎
黑帐篷	降央卓玛
长大后我就成了你	宋祖英
鱼	陈绮贞
未来在手中	孙楠
最美的春天	李健
Not Afraid	Eminem
告诉自己忘了他	本兮
Exodus（出埃及记）	Maksim
月牙湾	飞儿乐团
Alice in Wonderland	王若琳
倾国倾城	降央卓玛
\x,	零点乐队
渴死的鱼	DJ小可
信天游	阿宝,张冬玲
恋恋风尘	老狼
勿忘你	高安
从一片落叶开始	苏打绿,Priscilla Ahn
欢喜就好	陈雷
但愿人长久	王菲
征服	茜拉
Roar	Katy Perry
梦中人	宝贝,罗百吉
Electric Romeo	Immediate Music
浪花一朵朵	任贤齐
Here's To Never Growing Up	Avril Lavigne
得意的笑	李丽芬
友谊地久天长	小蓓蕾组合
乌苏里船歌	降央卓玛
深情相拥	张国荣,辛晓琪
You'Re Beautiful	James Blunt
二泉映月	阿炳
好想再爱你	颜亚涛
王铮亮 - 时间都去哪了 - Mqms	NULL
残酷的温柔	彭佳慧
千年之恋	呼斯楞,央吉玛
Stay Beautiful	Taylor Swift
Teenage Dream	Katy Perry
爱最大（国语版）	谢霆锋,欧豪
七秒钟的记忆 (feat. 孙羽幽 )	徐良
鸽子	宋冬野
般若波罗蜜多心经	齐豫
爱的路上只有我和你	任贤齐
你在烦恼什么	苏打绿
哭砂	黄莺莺
矜持	王菲
明天你是否依然爱我	童安格
漂洋过海来看你	周华健
滚滚红尘	高胜美
睫毛弯弯	蘑菇兄弟
有没有一种思念永不疲惫	许强
Royals	Lorde
漂亮的姑娘你别怕DJ舞曲	李贵府
刀剑若梦	周华健
你怎么舍得我难过	黄品源
绿岛小夜曲	邓丽君
等你爱我	陈奕迅
爱你不是两三天	梁静茹
A Place Nearby	Lene Marlin
错位节拍	单色凌,何艺纱
最终信仰	尚雯婕
闹花灯	正月十五
山茶花	邓丽君
当年情	张国荣
这一次我绝不放手	齐秦
夜机	陈慧娴
出水莲	古筝
转弯	吴奇隆
光脚丫	阿牛
给未来的自己	杨宗纬
天天看到你	阿杜
双截棍	周杰伦
飞向别人的床	网络歌手
爱要怎么说出口	赵传
儿行千里	刘和刚
Love Me	Justin Bieber
难念的经	周华健
忘记你太难（流行版）	阿里郎
Team	Lorde
问	陈淑桦
我用自己的方式爱你	陈明真
一生最爱的人	祁隆
Never Grow Up	Taylor Swift
贝多芬病毒	贝多芬
妈妈	祁隆
我要抱着你	庞龙
一块红布	崔健
寂寞的恋人啊	莫文蔚
小宇	张震岳
他不爱我	关喆
Shape Of My Heart	Sting
盛夏的果实	莫文蔚
钞票	迟志强
离开的时候	A-Lin
山谷里的回声	邓超,羽泉
Let It Go	Demi lovato
干杯朋友	田震
愿得一人心	张雨生
老师你好	阴三儿
星光	S.H.E
国际歌	唐朝乐队
水舞	游学志
天后	刘力扬
May It Be	Enya
城市之光	汪峰
昨夜星辰	高胜美
走进新时代	张也
Thank You	Dido
扯罩罩	喵喵
遗憾	许美静
一千个轮回	易丹
回来	马达,田雨莫
般若波罗密多心经	古筝佛赞
雨人	周华健
许多年以后	赵鑫
你身边的人曾经是我	阿宝,张冬玲
백일몽 (Evanesce)	Super Junior
Die Young	Ke$ha
Stay	Rihanna
雪人	范晓萱
一曲红尘	郭少杰
爱人	萧敬腾,田斯斯
你一定要幸福	何洁
走在红毯那一天	彭佳慧
我想大声告诉你	樊凡
Angel	塔斯肯
当你	林俊杰
回不去了	信乐团
想逃	罗志祥
Creepin' Up On You	Darren Hayes
下辈子如果我还记得你	马郁
一言难尽	张宇
不要再来伤害我	孙露
七月七日晴	许慧欣
怎么能够	羽泉
1981	石进
Heartbeats	Amy Diamond
怪你过分美丽	张国荣
为了让生活继续	汪峰
爱的路上千万里	韩宝仪
我的老故事 (나의 옛날이야기)	IU
听说爱情回来过	蔡依林
我们结婚吧	金志文
回头太难	张学友
缘分	五月
练习	刘德华
不哭了	BY2
不流泪的机场	林俊杰
分享	伍思凯
小手拉大手	梁静茹
爱爱爱爱	吴莫愁
One Love	Blue
Strength of a Thousand Men	Two Steps From Hell
葬花吟	郑绪岚
阴天	李宗盛
痴心换情深	周慧敏
大悲咒	佚名
一生何求	陈百强
终身大事	田馥甄
真的很在乎	杨坤
可惜我是水瓶座	杨千嬅
不想回家的女人	孙露
红日	李克勤
Pretty Boy (Lp Version)	M2M
心碎了无痕	张学友
茉莉花	纯音乐
月满西楼	卓依婷
Rock N Roll	Avril Lavigne
Nothing'S Going To Change My Love For You	Westlife
疼爱	萧敬腾
水中花	谭咏麟
爱上你我很快乐	水木年华
너의 모든 순간（你的所有瞬间）	成诗京
泥娃娃	儿歌
钓鱼岛是中国的	dj舞曲
向往神鹰	容中尔甲
最后一个夏天	金莎
黑猫警长	小蓓蕾组合
天使之泪	张翰
蒙古人	凤凰传奇
风之诺言	张翰
接纳	海龟先生
我们的路	筷子兄弟
第叁十八交响乐	胎教音乐
可惜不是双鱼座(新曲)	石进
快枪手	杨坤,萧敬腾
三国杀	张雨生
Lady Marmalade	G.E.M.邓紫棋
火辣辣的情歌	乌兰图雅
找你妹	王麟
十送红军	彭丽媛
把悲伤留给自己	孙露
无端相忆	NULL
光棍	胡歌
Black Or White	Michael Jackson
叹服	许嵩
兄弟干杯	庞龙
走了这么久	韩磊,刘婕
老派恋情	孔令奇
浪人情歌	伍佰
On The Radio	Groove Coverage
漫步	许巍
The hill of Thieves	Cara Dillon
最爱最恨都是你	李翊君
万壑松风图	史志有
小城大事	杨千嬅
嘟比嘟	DJ小可
难舍难分	谭咏麟
善意的谎言	NULL
忘不掉的伤	姜玉阳
only my railgun	fripSide
你是风儿我是沙	周杰,林心如
回心转意	张宇
Walking In The Air	Aled Jones
喜欢妳	Beyond
一个人失忆	薛凯琪
外婆的澎湖湾	蔡琴
红星照我去战斗	彝人制造
钱规则	丛浩楠
我要找到你	陈明
川藏路	扎西顿珠
奈何	费玉清
雨还是不停的落下	孙燕姿
与你到永久	伍佰
THIS IS LOVE (这就是爱)	Super Junior
再给我放一首	王啸坤
宝贝对不起	草蜢
When I Fall In Love	Celine Dion,clive griffin
Iridescent	Linkin Park
友情岁月	郑伊健
小芳	李春波
北京一夜	陈升,刘佳慧
一个人的北京	海鸣威
Breeze From The Sea	自然与神思合奏团
上帝是个女孩	欧美经典
红尘永相伴	冷漠,司徒兰芳
明天你好	莫茜茜
12월의 기적(Miracles in December)	EXO
望星空	董文华
Sexy music+冬天里的一把火	吉克隽逸,刘昊霖
四季歌	邓丽君
Que Sera Sera	Doris Day
寂寞是你给的苦	冷漠
爱本无罪	汤潮,岳思思
明天的明天的明天	动力火车
知心爱人	任静,傅迪生
梦中想着你	门丽
两全	张杰
好了伤疤忘了痛	孙子涵
在你之前我早已有了她	冷漠
伤城	张远
久别的人	白雪
我是不是该安静的走开	黎明
毕业那天	唐古
Melt The Snow	Shayne Ward
笑拥江山梦	高胜美
西门庆的眼泪	杨青
赤裸裸	郑钧
你快回来	孙楠
Perfect	Simple Plan
爱的奉献	韦唯
片片枫叶情	张智霖,许秋怡
趁早	孙露
龙电天下	王绎龙
人情味 (사람냄새)	Gary,郑仁
见或不见	何晟铭
痒	黄龄
Super Mo	吴莫愁
争气	吉克隽逸
HOLIDAY	T-ara
我终于失去了你	范玮琪,六弦
世上 只有妈妈好	儿童歌曲
红尘情歌 高安vs黑鸭子 _dj燕儿 remix	Dj燕儿
不爱的练习	沙宝亮
跟你一辈子	孙楠,徐千雅
Partita For Double String Orchestra: Iv. Fantasia (Allegro)	邓丽君
斗地主	王麟,安琥
你的温柔 DJQQ	子枫
花又开好了	S.H.E
三天三夜	张惠妹
I Remember	郭采洁
一眼瞬间	张惠妹,萧敬腾
求佛	誓言
臭男人	王麟
Because Of You	Kelly Clarkson
你在他乡还好吗	李进
弟子规	儿童歌曲
漂移	周杰伦
大男人	腾格尔
红梅赞	彭丽媛
Bleeding Love	Leona Lewis
学习雷锋好榜样	小蓓蕾组合
大悲咒	邝美云
勇敢爱	Mi2
What's Up?	刘雅婷
我被青春撞了一下腰	张真
想你的365天	肖洒,王琪玮
黄叶舞春风	罗百吉
酒后更想你	高安
沧海一声笑	罗大佑,黄霑,徐克
花仙子的花篮	莫扎特
我们说好的	张靓颖
叫一声哥哥你快回来	王二妮
Passionata 热情	Maksim
气球	许哲佩
미친거 아니야? (GO Crazy)	2PM
秋日私语	经典钢琴曲
愿赌服输	那英
枯叶蝶	许艺娜
友谊地久天长	黑鸭子
你是我的女人	刘德华
掌纹	倪鹏
等待	陈瑞
相信我	零点乐队
为什么相爱的人不能在一起	郑源
遇上你是我的缘	龚玥
美丽心情	本多Ruru
大城小爱	王力宏
桃花运	崔子格
短发	范玮琪,胡维纳
真爱你的云	黄国俊
你还记得我吗	徐怀钰
茉莉花	萨克斯
别让爱迷路	姚晨
火花	高耀太
月亮代表我的心	张国荣
可不可以不勇敢	范玮琪
欢乐颂	贝多芬
花魁	周旖喆
对望	林志颖
想着你亲爱的	孙露
Going Out	久石让
梁山伯与茱丽叶	曹格,卓文萱
我和我的祖国	平安
A	GOT7
我好想你	潘广益
她	马上又,杨坤
铃儿响叮当	儿童歌曲
Opera	林志炫
广场舞曲	乌兰图雅
Mi Mi Mi	Serebro
一见钟情	柳岩,黄灿盛
Nemo (Album Version)	Nightwish
蓝色故乡	乌兰图雅
Hello Seattle	Owl City
小跳蛙	青蛙乐队
千古绝唱	白雪
我是不是你最疼爱的人	葛林
电影票根	郑虹
草原之夜	古筝
d - 大调卡农	钢琴曲
忘了我	杨宗纬
色惑	杨千嬅
猪之歌	卓依婷
幸福女人	陈瑞
爱的狂怒	凤凰传奇
放心不下	黄小琥
伤痕	林忆莲
My Heart Will Go On	Celine Dion
翅膀之歌	塔斯肯
Mine	Taylor Swift
黄昏	周传雄
你的样子	罗大佑
小城故事	邓丽君
怪你过份美丽	张国荣
私奔到月球	五月天,陈绮贞
月光边境	林海
坐上火车去拉萨	DJ小可
梦不落	孙燕姿
今天是你的生日我的祖国	董文华
向前冲	徐怀钰
黑色蝴蝶	汪苏泷
危险世界	方大同
风的季节	徐小凤
上爱唱的歌	陶喆
都是酒精惹的祸DJ舞曲	何龙雨
开学恐惧症	高姗
请安静的忘记我	孙子涵,Sara
Treasure (Live)	余枫
于谦 - 屌丝青年	郭德纲
一万个舍不得	庄心妍
依依不舍	张信哲
Baby Boy	王心凌
今晚你想念的人是不是我	A-Lin
童年	黑豹乐队
雪之梦	Bandari
大海	小沈阳
奋不顾身	崔子格
中国少年先锋队队歌	中国少年先锋队队歌
紫藤花	S.H.E
青春是岁月的河	侃侃
土耳其进行曲	莫扎特
喜悦	许巍
姐姐妹妹站起来	陶晶莹
对不起	清清儿
我爱我的幼儿园	儿歌
烛光里的妈妈	羽泉
Little Girl In The World	林二汶
Burning	Maria Arredondo
喜欢你	G.E.M.邓紫棋
流行中文	Alex
北京的金山上	小蓓蕾组合
小苹果	王羽泽
什么都可以	黄晓明
红山果 - 原版 4.18	安与骑兵
青春舞曲	玖月奇迹
沙漠海	张宇
可爱的一朵玫瑰花	塔斯肯
听说爱情回来过	林忆莲
护花使者	李克勤
傻瓜与野丫头	张宇,徐熙娣
月半小夜曲 (Live)	陈乐基
豆浆油条	林俊杰
漫步人生路	刘德华
无尽空虚	Beyond
小毛驴	小蓓蕾组合
Stay Here Forever	Jewel
女人如烟	魏佳艺
玩腻dj版	Dj
小妹儿	高旭
心在跳情在烧	谢军
赛马	二胡
Trying Times	Boyz II Men
黄玫瑰	侃侃
大悲咒 - 龚玥 为你祈福	佛教音乐
鹿港小镇	罗大佑
宋家皇朝	喜多郎
Stars	George Winston
爱我中华	宋祖英
隐形的翅膀	张韶涵
爱笑的眼睛	徐若瑄
On The Floor	Jennifer Lopez,Pitbull
回味	樊凡
哭砂	林志炫
The Dawn	Dreamtale
再见亦是泪	谭咏麟
一千个伤心的理由	张学友
北郊	迟志强
我的未来不是梦	张雨生
不想你走	王洋
再见	小虎队
Paparazzi	Lady Gaga
心碎	龙梅子
你把我灌醉	黄小琥
鸭子	苏慧伦
任逍遥	任贤齐
Menuett #6	Liz Story
听着情歌流眼泪	高进
女驸马	李玲玉
热情的沙漠	庾澄庆
Everybody	SHINee
暧昧	王菲
伯牙绝弦	王力宏
她说	谢安琪
拉德斯基进行曲	斯特劳斯
马德里不思议	蔡依林
温柔	姚政,梁君诺
离家的孩子	陈星
我可以	蔡旻佑
失恋无罪	A-Lin
幸福家乡	安与骑兵
守候在凌晨两点的伤心秀吧	刀郎
陪我看日出	回音哥
祝你生日快乐	小蓓蕾组合
恋曲1980	罗大佑
爱在思金拉措	央金兰泽
Unleashed Love	丁丁
留什么给你	孙楠
陪我去流浪	阿悄
数天数	龚玥
农业重金属	阿宝,山花乐队
无地自容	周晓鸥
流浪歌手的情人	老狼
你是我胸口永远的痛	王杰,林忆莲
等你等了那么久	孙露
我们的生活充满阳光	于淑珍
无情的温柔	郑源
我最亲爱的	李代沫
当爱已成往事	李宗盛,林忆莲
只为你歌唱	佟丽娅
我好喜欢你	六哲
Angels	Robbie Williams
Hangover	Psy,Snoop Dogg
心碎北京	满江
舍不得忘记你	网络歌曲
The Glorious Death	冯曦妤
网络一线牵	安东阳
爱我别走	张震岳
When You're Gone	Avril Lavigne
你看你看月亮的脸	孟庭苇
Por Una Cabeza	汤玛斯 纽曼
最真的梦	周华健
Fragrant Fields	George Winston
穿越火线	谢霆锋
为梦而生	水木年华
彩虹天堂	刘畊宏
愁啊愁	迟志强
偏爱	张芸京
少年游	魏晨
梦高原	乌兰托娅
一个人哭	郑源
More Than Anyone	蔡健雅
倍儿爽	大张伟
我们的无奈	山野
爱与痛的边缘	谭咏麟
中国我爱你	凤凰传奇
对面的女孩看过来	任贤齐
朋友	谭咏麟
爱情万岁	玫瑰神话
你的背包	多亮
爱你在心口难开	高胜美
柠檬草的味道	蔡依林
等你等到我心痛	张学友
迷幻社会摇重鼓点电音	NULL
快乐的节日	小蓓蕾组合
红蜻蜓	小虎队
那个女孩(电影《前任攻略》主题曲)	韩庚
于谦 - 相声 我要旅游 德云社	郭德纲
望乡	满文军
如果缘只到遇见	吴奇隆
男人真累	张嘉洵
不怨	袁姗姗
不要在我的伤口撒盐	NULL
绽放	汪峰
新天龙八部	钟汉良
麦芽糖	周杰伦
走在红毯那一天	彭佳慧
背叛	杨宗纬
逝去日子	Beyond
芙蓉雨	NULL
交响童话	胎教音乐
心情	陈晓,赵丽颖
冰火DJ舞曲	李贵府
卖报歌	小蓓蕾组合
夜空中最亮的星	毛川
觉醒	汪峰
听说爱情回来过	李代沫
我在草原等你来	乌兰托娅
火花	DJ小可
要嫁就嫁灰太狼（Dj版）	周艳泓
Let Me Go	Avril Lavigne, Chad Kroeger
完美世界(主题版)	水木年华
风雨无阻	周华健
煎熬	田丹
如梦 (男版)	简红
青城山下白素贞	好妹妹乐队
我想爱	杨丞琳
Tik Tok	Avril Lavigne
雨蝶	李翊君
胡萝卜须	许嵩
救赎之旅	许巍
差一点	阿杜
Lucky	Colbie Caillat,Jason Mraz
无间道(国语版)	刘德华,梁朝伟
Eyes On Me	王菲
ROADS UNTRAVELED	Linkin Park
海阔天空	Beyond
幻听	许嵩
如果爱下去	张靓颖
多少柔情多少泪	韩宝仪
我的中国心	张明敏
21 Guns	Green Day
后会无期	徐良&汪苏泷
顺流逆流	徐小凤
小星星	少儿歌曲
梅花三弄	古琴
What Is Dancing	未知
又见炊烟	王菲
Greek Meditation 希腊冥想曲	Bandari
草原上升起不落的太阳	乌兰图雅
I Need Your Love	Ellie Goulding,Calvin Harris
大明劫	小野丽莎
느낌 아니까	T-ara
内蒙古黑怕	魏雪漫,MC
独上西楼	邓丽君
Nu Abo(NU 예삐오)	f(x)
大悲咒南无大慈大悲观世音菩萨	佛歌
Trap	Henry,圭贤,泰民
驼铃	蒋大为
简单爱	周杰伦
漂亮的姑娘你别怕 DJ版	李贵府
燕尾蝶	张欣奕
I Have Nothing	田丹
爱情错觉	王娅
一封家书	石进
敖包相会 (feat. 云飞)(电影《草原上的人们》插曲)	乌兰图雅
XOXO (Kisses & Hugs)	EXO-M
忘尘谷	NULL
Set fire to the rain	Adele
花儿为什么这样红	艾尔肯
金缕衣	姚贝娜
也许明天	张惠妹
All About That Bass	Meghan Trainor
鬼迷心窍	李宗盛
我的好妈妈[童声独唱]	儿童歌曲
朱砂泪	董贞
You	chris young
今生共相伴	谢霆锋
今生陪你一起走	冷漠
Mercy	张目
Sexyback	Justin Timberlake,Timbaland
谁是大英雄	张学友
Disturbia	Rihanna
爱转角	罗志祥
I Need A Doctor	Eminem
夏天的味道	许飞
嫦娥	徐子崴
活埋	李涛
异想记	杨幂
一个爱上浪漫的人	孟庭苇
叫醒爱	何润东
舞娘	蔡依林
其实你不懂我的心	童安格
高飞	张杰
Locked Out Of Heaven	Bruno Mars
比较幸福	孙燕姿
愿望	胡彦斌
没有我你怎么办	何润东
领悟	林忆莲
复刻回忆	方大同,薛凯琪
Paralyzer	Finger Eleven
身不由己	丁当
傻瓜	温岚
Relief	Chris Garneau
改变自己	最美和声选手
幽灵公主	轻音乐
High歌	张玮,黄龄
今夜你会不会来	黎明
月光爱人	李玟
酸酸甜甜就是我	张含韵
一生中最爱	李克勤,谭咏麟
溜溜的山歌溜溜的唱	皆大欢喜
谁明浪子心	王杰
谎言	BigBang
千年缘	心然
喀秋莎	黑鸭子
Holy Grail	Jay-Z,Justin Timberlake
红尘情歌	石雪峰
残忍的缠绵	刘忻
牧羊曲 - 电影 少林寺 插曲	李玲玉
深呼吸	羽泉
娃娃脸	后弦
浪子心声	郑中基
要死就一定要死在你手里 (feat. 郑钧)(live版)	莫西子诗
知道不知道？	刘若英
小三你好贱	本兮
想着你亲爱的	刘恺名
坐上火车去拉萨	徐千雅
今夜舞起来	张冬玲
香水百合	张韶涵
爱最大（粤语版）	谢霆锋,廿四味
如果爱下去	张靓颖
奇异恩典	北京天使合唱团
She Will Be Loved	Maroon 5
爱情	莫文蔚
血染的风采	董文华
小螺号	群星
Heaven’s Day	东方神起
爱情神马价	易欣
说一句我不走了	小5
Catch My Breath	Kelly Clarkson
环游	华晨宇
感恩的心	苏芮
逍遥行	许巍
最爱的人伤我最深	张惠妹
新不了情	张靓颖
死了都要爱	信乐团
错爱情歌	庄心妍
甩葱歌	初音未来
战歌	dj舞曲,DJ
画心Ⅱ	张靓颖
谁的眼泪在飞	孟庭苇
芭啦芭啦樱之花	郭富城
不会再让你哭	祁隆
超模	郑希怡
月亮之上+自由飞翔 雷鬼舞曲版	凤凰传奇
天涯歌女	韩宝仪
Kiss Goodbye	王力宏
麻木 - x8 飞曲 好听也好玩 麻木作品 mp326	MC
雨樱花	飞儿乐团
赶牲灵	王二妮,冯晓泉
Us Against The World	Westlife
Love Love Love	蔡依林
世界第一的公主殿下 - miku	初音未来
Anytime	Kelly Clarkson
爱要坦荡荡	萧萧
不眠之夜 (잠 못드는 밤)	Crush, (Punch)
Loving You	Kenny G
一帘幽梦	许茹芸
牧马少年	乌兰托娅
天灰	S.H.E
飞蛾扑火	彭丽丽
Big Big World	Emilia
亲亲我的宝贝	周华健
凤凰展翅	司徒兰芳
云朵	云朵
木兰星	张靓颖
难忘的一天	许巍
Good As You	张铠麟
牧人	降央卓玛
Canon In D - II	Pachelbel,Renaissance Ensemble
我想有个家	潘美辰,柯以敏
邓紫棋 - 喜欢你--粤语-幷四【樱姿】制作	
A l'envers	Rose
Without You	Mariah Carey
传世乐章	汪苏泷
酒醉的探戈2001	动力火车
干杯	五月天
沧海一声笑	董贞
Staring at the Sun	U2
怎么唱情歌	刘惜君
出卖我	程响
封面恋人	魏晨
离殇	小5
爱夏	胡夏
蜗牛	周杰伦
偶然	罗百吉
心酸	林宥嘉
Black	G-Dragon,Jennie Kim
돌아보지 마	崔振赫
末班车	萧煌奇
问剑	董贞
多年以后	姜育恒
夜半歌声	张国荣
为龙	河图
多情的人总被无情的伤	六哲
Baby One More Time	Britney Spears
新鸳鸯蝴蝶梦 + 千万次的问 + 流星雨 + 存在 + 大笑江湖	小沈阳,田斯斯,胡维纳,肖洒,肖懿航,王琪玮,唐一嘉,丁泽强,陈俊豪
往事只能回味	蔡琴
彼岸花	王菲
谁才是你今生最爱的人DJ版	何龙雨
英雄联盟	乱感觉
今生有你	龙梅子
不痛	樊凡
铁血丹心	甄妮
原谅我	萧敬腾
D大调嬉游曲	胎教音乐
入迷（Spellbound）	东方神起
红豆红	邓丽君
It's My Party	Jessie J
好乐Day	王蓉
亲爱的姑娘我爱你	草原歌曲
棋子	王菲
大海	张雨生
One Night In 北京	信乐团
你的意味 (너의 의미)	IU, 
Kissy, Kissy	Smile
糊涂的爱	江珊,王志文
尘埃	家家
有钱没钱回家过年	龙梅子
一帘幽梦	高胜美
hold住爱	龙梅子,老猫
午夜唱情歌	姜玉阳
亲爱的你可知	程响
看见什么吃什么	苏梦玫
情归草原	云飞
爸爸妈妈听我说 - 铃 金苗有声图书馆	儿童歌曲
How Long Will I Love You	Ellie Goulding
浪费	林宥嘉
在那东山顶上	云飞
你爱我像谁	张卫健
짧은 치마 (Miniskirt)	AOA
Dragon Rider	Two Steps From Hell
鬼步舞曲	dj舞曲
How You Remind Me	Avril Lavigne
空间专用 社会摇	NULL
仰望星空	张杰
小城大事	张学友
第二天 (다음날)	Juniel
祝福	张学友
神话	纯音乐
Ariari(阿里阿里)	李贞贤
别看我只是一只羊	杨沛宜
我们的故事	戴佩妮
缘	高胜美
星语心愿	张柏芝
End Credits	Hans Zimmer
莲师心咒	仁钦林巴仁波切
启程	范玮琪
凤凰劫	河图
敖包相会	蔡琴
We Found Love	Rihanna,Calvin Harris
Valparaiso	Darby Devon
Try	P!nk
大海啊故乡	谭晶
爱神	钟汉良,胡杨林
命运交响曲	贝多芬
都是夜归人	许美静
Letting Go	蔡健雅
明天你是否依然爱我	童安格
我叫mt	群星
一无所有	王杰
梁祝（化蝶）	彭丽媛
Give Love	乐童音乐家
当爱已成往事	辛晓琪,周华健
一拍两散	许佳慧
Mad World	崔天琪
K歌之王	陈奕迅
缺口	林凡
会呼吸的痛	曹寅
歌唱祖国	杨沛宜
Melon Street Book Club	Tamas Wells
Love Someone	Jason Mraz
外婆桥	儿歌
红雨	孟庭苇,李翊君
轻轻	本兮
Our Song	Taylor Swift
Girlfriend	Avril Lavigne
喂！喂！	周笔畅
伤心城市 对唱	冷漠,云菲菲
我愿意(霍尊PK祈汉)（声动亚洲）	霍尊,祈汉
黄玫瑰	黄灿
梦带我旅行	高进
Boulevard Of Broken Dreams	Green Day
梦断楼兰	何龙雨,程欣
伤不起(DJ版)	老猫
春泥	庾澄庆
最浪漫的事	赵咏华
水云间	凤凰传奇
Time After Time	Cyndi Lauper
不如跳舞	陈慧琳
日光倾城	卡奇社
괴도 (Danger)	泰民
姑娘爱情郎	慕容晓晓
好汉歌	刘欢
胡杨新娘	凤凰传奇
I Believe	孙楠
Walk Away	Dia Frampton
Nothing In The World	Atomic Kitten
袖手旁观	齐秦
我和我的祖国	李谷一
包子铺（民族女声版）	谈芳兵
小李飞刀	罗文
Dar um Jeito (We Will Find A Way）	Santana,Wyclef,Avicii,Alexandre Pires
洪湖水浪打浪	宋祖英
把我的悲伤留给自己 - 江湖 电影原声大碟	林苑
各自远扬（声动亚洲）	霍尊
粉红色的回忆	韩宝仪
Paradise In Love	李敏镐
一生爱你千百回	梅艳芳
誓要入刀山	郑少秋
涛声依旧	费玉清
你的微笑	那英
我记得我爱过	何润东
茉莉花（声动亚洲）	霍尊
俩俩相忘	辛晓琪
光之翼	王菲
后青春期的诗	五月天
流沙	陶喆
空虚，沸腾	本兮
永远	张靓颖
最炫民族风	叶玮庭,李秋泽
夜の潮	高维那
Where Are You Now	George Winston
上海滩	叶丽仪
车站	高胜美
一直很安静	阿桑
骊歌	GALA
幸福了 然后呢	A-Lin
一路上有你 (Live)	张碧晨;魏雪漫
伤心城市	云菲菲,冷漠
Love Is... (Acoustic ver.)	
又见炊烟	韩宝仪
想你啦	龙梅子,冷漠
谁让我爱上你	汤潮
你是我生命中的礼物	乌拉多恩
泰坦尼克号主题曲	黑鸭子
Ooh La La	Goldfrapp
女友结婚了新郎不是我 - m 24s	印度歌曲
7 Days	Craig David
恋着多喜欢	梁静茹
十五的月亮	董文华
说书人	小沈阳
93 Million Miles	Jason Mraz
爱江山更爱美人	卓依婷
The Power Of Love	Céline Dion
好甜好甜的梦	胎教音乐
心跳	杨谨
伞下	张宇
还记得吗	曹轩宾
倒带	蔡依林
好久不见	陈奕迅
Yesterday	The Beatles
兔子舞	群星
你是我的眼	动力火车
钢琴曲 梁祝	群星
Can You Feel My World	王力宏
Christmas Day	EXO
The Raising Fighting Spirit	火影忍者
莫斯科郊外的晚上	李玉刚
小河淌水 Flowing Creek	纯音乐
Nobody But You	Backstreet Boys
我爱你塞北的雪	玖月奇迹
梦田	齐秦,齐豫
霸王别姬	屠洪刚
All Rise	Blue
独自去偷欢	刘德华
阳光宅男	周杰伦
他夏了夏天	苏打绿
预谋	DJ,小杰
青春无悔	老狼,叶蓓
最后一次的温柔	蓝雨
九鼎天下	NULL
九九女儿红	陈少华
浪漫爱	江语晨
海阔天空	Beyond
恰似你的温柔	程响
直到世界终结	动漫原声
婚礼	The Daydream
Missing You	G-Dragon,金润雅
团结就是力量	霍勇
在希望的田野上	彭丽媛
完美人生	程响
莫失莫忘	胡歌,仙剑奇侠传三主题曲
最亲爱的你	范玮琪
我是一只小小鸟	赵传
Dima	Zaho
最长的电影	陈僖仪
想象之中	许嵩
歌唱祖国	大合唱
鸽子情缘(鸽子园主题曲)(粤)	刘德华
我的未来不是梦	张雨生
银泰	孙燕姿
谢谢侬	陈奕迅
将军令	吴克群
梦回云南	白玛多吉
好人一生平安	李娜
菊花台	李玉刚
爸爸去哪儿(英文版)	电视原声
暧昧	杨丞琳
别害怕	罗震环
我想我不够好	单色凌
Bad Romance	Lady Gaga
月儿像柠檬	龙飘飘
如果爱老了	杨幂,刘恺威
唐伯虎点秋香	过江龙
月牙儿	赵本山
Amazing Grace	林育群
Breath and Life	Audiomachine
阿哥阿妹	谢军
摇篮曲	彭丽媛
佛说圣佛母般若波罗蜜多心经	王菲
金刚经	佛教音乐
缠绵	刘德华
幼稚完	林峯
做你的爱人	饶天亮
相思的滋味	韩宝仪
真的好想你	卓依婷
你还欠我一个拥抱	后弦,Sara
最冷一天	张国荣
虐心	NULL
恩爱小夫妻	朱贝贝
杯水情歌	庞龙
哭过的天空	苏慧伦
映山红	阿鲁阿卓
你在哪里	筷子兄弟
皇后大道东	罗大佑,蒋志光
姑娘我爱你	索朗扎西
呼吸	蔡健雅
多情人都把灵魂给了谁	李翊君
今生今世	张国荣
城府	许嵩
两个人的事	李代沫
Honestly	Jo De La Rosa
我恨自己动了真情	冷漠
The End Of The World	Skeeter Davis
开门红	火风,汤灿
归去来	胡兵,希莉娜依
永远永远	李翊君
爱人跟人走	卓依婷
爱我的人和我爱的人	游鸿明
街舞少年	TF家族
出卖我 - 慢摇嗨曲 加快版 dj 阿呆上传	程响
那些年 (Back Then)	张力尹
男人Ktv	胡彦斌
出卖我 - dj 最新版本	程响
爱上你是一个错	杨培安
答应不爱你	程响
美丽的神话	胡歌
无条件为你	梁静茹
我这个你不爱的人	迪克牛仔
Only One (inst)	宝儿
Dying In The Sun	The Cranberries
伤心的人别听慢歌（贯彻快乐）	五月天
Soledad	Westlife
You Belong To Me	Jason Wade
给你们	孙露
Outlaws Of Love	Adam Lambert
红豆	王菲
寓言	张韶涵
怕你伤心怕你哭	冷漠
Won'T Go Home Without You	Maroon 5
我会想起你	丽江小倩
我可以	蔡旻佑
信者得爱	郑秀文
Ulysse	Ridan
杀破狼	JS
苦果 - 苦果程响 苦果下载	程响
七秒钟的记忆	徐良vs孙羽幽
我是一只鱼	任贤齐
梵文	超好听,大悲咒
倩女幽魂	张国荣
Beat It	迈克尔杰克逊
我爱洗澡	范晓萱
没那么坚强	程响
苦果 - 天地人	程响
我难过	5566
没那么简单	胡彦斌
爱上一个梦	程响
Home	Westlife
不该相遇在秋天	程响
护花使者	李克勤
分开那天	程响
分手了还是朋友	程响
Sorry, Sorry	Super Junior
情人节的夜晚	本兮,小贱
你飞到城市另一边	好妹妹乐队
心跳	王力宏
忘情酒	安东阳
Domino	Jessie J
那一世	陈翔
下定决心忘记你	网络歌手
200%	乐童音乐家
滴答滴 - 北京爱情故事 l	侃侃
眼泪的错觉	群星
在你离开那一天	汪东城,曾沛慈
S&M	Rihanna
难得有情人	关淑怡
小步舞曲	胎教音乐
委屈	梁佳玉
序曲：时间的歌	陈绮贞
映山红	韩红
玉石俱焚	程响
爱的箴言	罗大佑
回忆的画面	程响
我们去探险吧	拜尔娜,姜琪航,王睿卓,张钰琪,曲婉婷,蹇佳成
经常回家看一看	程响,王羽泽
红绿灯	周子琰
很受伤	程响
白素贞	NULL
好人一生平安	李娜
月亮船	杨钰莹
在树上唱歌	郭静
赤道和北极	王雅洁
喊麦	DJ,小枫,洪磊,MC
冬季到台北来看雨	程响
Partita For Double String Orchestra: Iv. Fantasia (Allegro)	吉克隽逸
害怕	带泪的鱼
出墙	程响,王嘉南
真心换伤心	程响
妈妈我想你	汤潮
Wonderful Tonight	Eric Clapton
出卖我 - 2012 - dj 加快版	程响
出卖我 - dj 子亮 2012加快版 高品质	程响
Shotgun Senorita	Blue Stahli
我愿	央金兰泽
北京的金山上	韩红
玖月情歌	玖月奇迹
修女的伤	程响
弄你迪士高 - 弄你	DJ舞曲
Colorful Days	朴树
心云	林志颖
单身歌	庞龙
往事只能回味	高胜美
你在烦恼什么	张新,刘籽辰
黑眼圈	汪苏泷
燕儿飞	宋小宝,王一璠
爱得太迟	古巨基
冰山上的雪莲	郑钧
你究竟有几个好妹妹	孟庭苇
追	香香
如果这都不算爱	陈奕迅
天之痕	钢琴曲
黄玫瑰	乌兰托娅
当我们一起走过	苏打绿
天堂	腾格尔
你是我的菜	王麟
Wild Wild Love	Pitbull
出卖我 - dj 志勇 潮流版	程响
蔓莉	韩宝仪
青花瓷	龚玥
移情别恋	郭峰
我的路	单冲峰
Steppe, Endless Steppe  (Arr. V. Afanasiev)	St. Petersburg Male Voice Choir,Vadim Afanasiev
那滋味	汤潮
我爱你中国	谭晶
贪图	李代沫
春雨里洗过的太阳	王力宏
我不会一个人	王铮亮,刘涛
命运不是辘轳	经典老歌
心照一生	RubberBand
反璞归真	屠颖
忧伤倒数	小昔米
模特	李荣浩
我说亲爱的	龙梅子,杨海彪
船歌	邓丽君
辛德瑞拉	丁丁
我们能不能不分手	花儿乐队
天天想你	陈绮贞
Traveling Light	Joel Hanson
头发乱了	张学友
纳西情歌	陈思思
爱啦啦	海楠
七友	梁汉文
向阳花	汪峰
咆哮 (Growl)	EXO-M
青藏高原	李娜
星光	凤凰传奇
我爱你中国	彭丽媛
九道弯	小沈阳
再回首	羽泉
Flower Dance	DJ OKAWARI
芦花	雷佳
怪怪女	青鸟飞鱼
隐身守候	孙子涵
邓紫琪 - 喜欢你	NULL
男神	柳岩
Shine (闪耀)	J-Min
连哭都是我的错	东来东往
延安颂	李双江
词不达意	林忆莲
听！是谁在唱歌？	刘若英,黄韵玲
Umbrella	Rihanna
One Day In Spring	Bandari
只要你过得比我好	钟镇涛
生日歌	英文歌曲
月满西楼	童丽
一分后 (After A Minute)	Super Junior-M
Lucky	EXO-M
悲伤的天使	钢琴曲
Better In Time	Leona Lewis
深山禅林	古筝佛赞
六字大明咒	耀一法师
唱支山歌给党听	张冬玲
Stay With Me	太阳,G-Dragon
心碎	易欣
狐狸精	罗志祥,米娜
只有你 (너 하나만)	金泰宇
不再让你孤单	陈升
出卖我 - a 版 2012 - dj 伟伟 mix	程响
其实我介意	小雪,林汉洋
缘	高胜美
茉莉花	宋祖英,Celine Dion
I Could Be The One ( Lp Version )	Donna Lewis
思念是一种病	蔡健雅,张震岳
浏阳河	童丽
Long Long Journey	Enya
再见理想	Beyond
傻女	陈慧娴
星星的妈妈	华子,周子琰,张楚,回音哥,侯磊
听袁惟仁弹吉他	周杰伦
旅程	蔡依林
怀念战友	云飞
出卖我 - 博白 dj 蓝锦 疯狂版	程响
我曾用心爱着你	潘美辰
出卖我 - dj 小波 2012 - remix	程响
出卖我 - dj 大雪 慢摇 大雪 remix	程响
胆小鬼	梁咏琪
Eenie Meenie (Feat Sean Kingston)	Justin Bieber,Sean Kingston
刀剑如梦	平安
童话	光良
太爱你	刘忻
当爱离别时	龙梅子
爱情	莫文蔚
小提琴	卡农
神话情话	周华健,齐豫
微笑以后	张靓颖
爱情的故事	方季惟
Wake Me Up When September Ends	Green Day
The Show	Lenka
为你而活	神木与瞳
Say Something (feat. Christina Aguilera)	A Great Big World
我的心好冷	Sara
平淡日子里的刺	宋冬野
九九艳阳天	阎维文,谭晶
寂寞难耐	李宗盛
Conquest Of Paradise	Vangelis
肾上腺素 (Adrenaline)	少女时代-太蒂徐
水晶	徐怀钰,任贤齐
butterfly	和田光司
그대 한 사람	金秀贤
2013深港最新中文串烧大碟	DJ
阳光下的星星	金海心
Vida	Ricky Martin
天使的翅膀	西单女孩
都是缘分惹的祸	安东阳
倾国倾城	费玉清
千年之恋	信乐团,戴爱玲
I See Fire	Ed Sheeran
三生石 三生路	阿兰
康定情歌	蔡琴
夜夜夜夜	叶秉桓
冰冰	程响
Lost In Paradise	王若琳
我从草原来 全新缩混版	凤凰传奇
照顾自己	张含韵
Fireflies	Owl City
Dancing Queen	少女时代
侥幸者	刘思涵
这一拜(桃园结义歌)	刘欢
短发 (단발머리)	AOA
守护	樊凡
我的心太乱	周传雄
爱多一次痛多一次	谭咏麟
出卖我 - dj - dj - mix - 2012 天皓	程响
五百年长海桑田	西游记
戏梦	林志颖
偏执面	张惠妹,蛋堡
痴	王安迪
一直想着他	庄心妍
火了火了火	王蓉
纤夫的爱	于文华,尹相杰
Guilty All The Same	Linkin Park,Rakim
催眠曲	爱德华 格里格
아랫입술 물고	Esna
蜗牛〖演唱会〗	周杰伦
南无本师释迦牟尼佛	古筝佛赞
永不退缩	任贤齐
Blow	Ke$ha
爱我你就抱抱我	吴文煜
寂静之声	姚斯婷
小螺号	程琳
等到来生再相遇dj	程响
老板情歌	曹越
不要对我说	程响
窗外	邓丽君
Secrets	OneRepublic
孤单北半球	欧得洋
Satellites	James Blunt
龙文	谭晶
在那东山顶上	谭晶
鸿雁	沙宝亮
Heaven	滨崎步
大好河山	玖月奇迹
This Love	Maroon 5
青藏高原	韩红
小步舞曲	贝多芬
活得潇洒	谭咏麟,陈慧娴
星光	S.H.E
红尘叹	陈瑞,冷漠
老公PK老婆	DJ小可
Baby One More Time	Britney Spears
错过了缘分错过你	何龙雨
南无观世音菩萨	许巍
南山南	马頔
十二生肖	王力宏
因你而在	林俊杰
策马奔腾 桑巴舞曲版	凤凰传奇
骑士精神	蔡依林,周杰伦
御龙吟	姚贝娜
再见小时候	南拳妈妈
May It Be	Enya
Boom Bi Boom	S翼乐团
我期待	卓义峰
兄妹	陈奕迅
这一路走来	杨宗纬
浏阳河	李谷一
出卖我 - b 版 2012 - dj 伟伟 mix	程响
一生守候	王若琳
我爱台妹	Mc Hotdog
为爱疯狂	中国好声音
红尘情歌 郑源&蒋姗倍 -djv-club-mix 新版	佚名
爱情海	央金兰泽
放手了吗	带泪的鱼,蝎子
情话连篇	颜小健
木偶 (마리오네트)	Stellar
Some (썸)(feat. 릴보이 Of 긱스)	昭宥,Junggigo
上山打老虎	小蓓蕾组合
莫斯科郊外的晚上	黑鸭子
Santorini	Yanni
Heal The World	Michael Jackson
少年壮志不言愁	刘欢
最高的幸运 (최고의 행운)	CHEN
三月里的小雨	刘文正
Beautiful	Eminem
你说我容易吗	小柯
大国民	郑智化
天使	五月天
天才白痴梦	许冠杰
对你的爱越深就越来越心痛	张学友
Soul	少女时代
La Song	Rain
除了春天爱情和樱花 (봄 사랑 벚꽃 말고)	High4,IU
泪桥	伍佰
克罗地亚狂想曲	马克西姆
定风波	张学友
沂蒙山小调	彭丽媛
我的祖国	玖月奇迹
看海	周迅
You Are The One	C21
壮志在我胸	李宗盛
山楂树	常石磊
快活	曲婉婷
罗生门	罗志祥
健康歌	范晓萱
英雄之战	陆毅
把爱深藏	侃侃
我爱这蓝色的海洋	吕继宏
一万个对不起 DJ版	NULL
昨天	梁静茹
突然想到理想这个词	郝云
merry christmas	圣诞歌曲
请喝一杯下马酒	降央卓玛
我喜欢	梁静茹
童年	罗大佑
征服	杨宗纬
是否	苏芮
南屏晚钟	蔡琴
Day By Day	T-ara
遗物(电视剧《法外风云》主题曲)	许廷铿
当你	回音哥
Birthday	Katy Perry
真的想回家	汤潮
痴心绝对	李圣杰
眼色	林宥嘉
空虚 (empty)	WINNER
Super Style	SpeXial
Falling Slowly	Linda Eder
没关系,是爱情啊 (괜찮아 사랑이야)	Davichi
多情总为无情伤	降央卓玛
在我想起来	李代沫,吉克隽逸
九分之一的恋人	柯以敏
天空	蔡依林
Superstition	Stevie Wonder
如果没有你	莫文蔚
烟花三月下扬州	刘紫玲
寸草心	东方传奇
要嫁就嫁灰太狼	周艳泓
火火的姑娘	吉特巴
Season 2	INFINITE
还剩下什么	羽泉,苏慧伦
永远不回头	张雨生,王杰
花开半夏	爱朵女孩
爱的代价	李宗盛
爱情一阵风	卓依婷,林正桦
绒花	韩红
路灯下的小姑娘	凤凰传奇
我的傻妹妹	张玮
Five Hundred Miles	Justin Timberlake,Stark Sands,Carey Mulligan
好人好梦	邰正宵
两地情缘	程响,王羽泽
校园的早晨	少儿歌曲
翻身农奴把歌唱	刀郎,黄灿
没有你的日子我真的好孤单	韩晶
等到来生再相遇	程响
小花	百慕三石
离开你并非是我愿意	陈瑞
你的眼神	卫兰
燕尾蝶	梁静茹
情醉	董贞
天雷地火	萧亚轩
黑骏马	乌兰托娅
手扶拖拉机斯基	张蔷
I Surrender	Céline Dion
Bad Day	Daniel Powter
最重要的小事	五月天
你潇洒我漂亮	韩宝仪
离开你不是因为我的冷漠	冷漠
跳起来 唱起来	玖月奇迹
吉他曲	轻音乐
七情六欲	李翊君
Last Romeo	INFINITE
蝶恋花	牛奶咖啡
他不爱我	金莎
Pompeii	Bastille
두 사람(两个人)	
只爱高跟鞋	葛泓语
悲	带泪的鱼
沙漠寂寞	李翊君
还是会寂寞	陈绮贞
艾琳娜	动力火车
兵马俑	凤凰传奇
只要为你活一天	谢霆锋
春来了	刘相松
国家	成龙,刘媛媛
心相印手牵手	杨钰莹
Road	George Winston
生日快乐	伊能静
在心里从此永远有个你	高安
驼铃	降央卓玛
饿狼传说	张学友
打工十二月	迟志强
Back At One	Brian Mcknight
蒲公英的约定	钢琴曲
My Destiny（你是我的命运）	LYn
玫瑰人生（声动亚洲）	小野丽莎
母亲	汪峰
陈永馨 刘珂《如果云知道》	中国好声音
天边	布仁巴雅尔
梦想天空分外蓝	陈奕迅
不如不见	陈奕迅
Unconditionally	Katy Perry
可惜不是你	梁静茹
江湖啊，江湖	小沈阳
大中国	高枫
全世界宣布爱你	孙子涵,李潇潇
小恋曲（DJ版）	徐良
冷冷再见	带泪的鱼
熊出没主题曲(我还有点小糊涂)	佚名
还好	东南
红尘情歌	张傲_黑鸭子
In Your Hands	Jason Mraz
Someone Like You	郑虹
Roar	Katy Perry
雨的秘密	温岚
淋雨一直走	NULL
夜空中最亮的星	NULL
魅惑钢琴	钢琴曲
123木头人	黑Girl
回家见爹娘	皆大欢喜
爱很简单	张学友
跟着感觉走	李秋泽
放心去飞	小虎队
至少还有你(国语)	张国荣
爱要有你才完美	梁博,那英
摇篮曲	小蓓蕾组合
Moves Like Jagger	Maroon 5
上邪 - 唱	小曲儿
心恋	徐小凤
哭笑不得	阿悄
爱陕北	王二妮
雕花的马鞍	德德玛
爱的双重魔力	By2
TONIGHT	BIGBANG
吃喝嫖赌抽	阿权
万水千山总是爱	安东阳,樊桐舟
Something	东方神起
幸福就是	刘若英
花香	许绍洋
情人	邓紫棋
念亲恩	陈百强
地球仪	动漫原声
On The Floor	Jennifer Lopez
寒江雪	郑源,储兰兰
情难枕	高胜美
相逢是首歌	俞静
天亮以后	胡歌
假装	刘德华
BAM BAM BAM 嘣嘣嘣	DJ舞曲
自挂东南枝 - 十万个冷笑话版	周杰伦
无语	本兮
学会	李行亮
流星	郑钧
If I Let You Go	Westlife
想你的夜	关喆
宝贝	莫文蔚
孤单背影	陈慧娴
你懂的DJ舞曲	李贵府
想把我唱给你听	王筝
蒲公英	范玮琪
Almost Lover	A Fine Frenzy
谁都不要说分手	冷漠,龙梅子
爱的供养	何晟铭
等你爱我	小柯
蝴蝶	胡彦斌
爱笑的眼睛	徐若瑄
洪湖水浪打浪	彭丽媛
Celebration	Madonna
小情歌	多亮,周笔畅
忘记	周传雄
其实我真的很在乎	姜育恒
爱情三十六计	蔡依林
千言万语	邓丽君
相思垢	金莎
Can T Get You Out Of My Head (Extended Mix)	Kylie Minogue
寂寞列车	汪峰
当你孤单你会想起谁	张栋梁
不是真的爱我	孙燕姿
Break Down (Inst)	Super Junior-M
伴奏	亡灵序曲,女生版
涛声依旧	毛宁
降龙十八掌	孙子涵
好姑娘	李晓杰
你会爱我到什么时候	雷婷
The Magnificent Seven - Suite	群星
时间的漩涡	任重
好男儿	韩磊
亲爱的你可知(奇葩版)	程响
琴师	音频怪物
滚滚红尘	陈淑桦
我在想念你	郑源
简简单单	林俊杰
岛歌	陈悦
野百合也有春天	罗大佑
E.T.	Katy Perry
草原上升起不落的太阳	降央卓玛
失真	G.E.M.邓紫棋
无心睡眠	张国荣
康电情歌 (激情版)（Remix版）	王绎龙
我的声音	丁丁
父亲的草原母亲的河	德德玛
Make You Mine	刘雨潼
凤凰于飞 (京剧版)	霍尊
这一刻爱吧	付辛博
如果风不再吹	汪峰
忘川河	风萧萧
爱火烧	大张伟
你不知道的事	桂雨濛
里约热内卢	杨坤
明年今日	陈奕迅
下马酒之歌	德德玛
忆红莲	洛天依
自作多情	本兮
Kiss Goodbye	王力宏
义勇军进行曲	国歌
Merry Go Round	久石让
铁血丹心	罗文,甄妮
我爱你不是因为你爱我	冷漠
背叛者	带泪的鱼
执迷不悔	王菲
哑巴新娘	李羿慧
最坏时候遇上最好的你	阿鲁阿卓,陈键锋
Electric Shock	f(x)
美梦成真	许茹芸
找个好人就嫁了吧	刘思伟
Speak Now	Taylor Swift
I Just Called To Say I Love You	Stevie Wonder
牧羊曲	郑绪岚
天空	王菲
刀剑如梦	董贞
I Feel Good	吉克隽逸
离开以后	张学友
伤心的歌	高进
同一首歌	黑鸭子
忍不住原谅	温岚
王妃	尚雯婕
爱的就是你	NULL
寂寞才说爱	刘可
Ten (10 Years)	东方神起
为你我受冷风吹 (Live)	胡彦斌
brave heart	宮崎歩
挑衅	信乐团
东极岛岛歌	上海音乐学院学生
离开地球表面	五月天
中学时代	水木年华
下一秒	G.E.M.邓紫棋
活着Viva	谢霆锋
有时寂寞	陈慧琳
朋友的酒 - 喊麦 中文 2011年9月19日	MC,小月
为梦想领跑	容中尔甲
面具(中文版)	安七炫
中意他	梁咏琪
流泪的红烛	祁隆,阿斯满
The Edge Of Glory	Lady Gaga
稳稳的幸福	孙俪
幽兰操	王菲
楼道	刘美麟
エウテルペ	Egoist
乌兰巴托之夜	降央卓玛
花心贼	崔子格
众人划桨开大船	付笛生
被动	伍佰
Never Grow Old	The Cranberries
梦遗少年	宋冬野
霍元甲	周杰伦
为梦而狂	关喆,茜拉
숨소리 (Breath)	TAEYEON,JONGHYUN
我再也不相信爱情了	崔子格
中国节	皆大欢喜
Yesterday Once More	Carpenters
1874	陈奕迅
君をのせて	宫崎骏
花儿为什么这样红	刀郎
为你我受冷风吹	林忆莲
新阿瓦尔古丽	刀郎
狠狠哭	郭采洁
我曾用心爱着你	潘美辰
终于明白	动力火车
九九艳阳天	奚秀兰
花满楼	李玉刚
我的烦恼	六哲
Jambalaya	Carpenters
大地	黄家驹
弹起我心爱的土琵琶	铁道游击队插曲
午夜怨曲	Beyond
刀马旦	李玟,周杰伦
We Own It (Fast & Furious)	Wiz Khalifa,2 Chainz
Love Is an Open Door	Various Artists
于心有愧	陈奕迅
新不了情	万芳
被遗忘的时光	蔡琴
东风破	周杰伦
能不能	王麟
倾尽天下	河图
相濡以沫	阿鲁阿卓
但愿人长久（声动亚洲）	霍尊,韩真真
You Are Beautiful	韦礼安
晨雾中的日出	蒋勋
光辉岁月	迪克牛仔,杨培安
玫瑰人生	理查德·克莱德曼
眼色	梁君诺
嫦娥	李玉刚
男儿当自强	成龙
再见!我的爱人	邓丽君
爱人	屠洪刚,王菲菲
好爸爸，坏爸爸	小蓓蕾组合
平沙落雁	林克仁,古琴,洞箫,刘正春
Don T Treat Me Like A Fool	Blue
拉拉爱(英文版)	DJ小可
带我到山顶	王睿卓
战争	陈冠希
水手	郑智化
记得我曾爱过你	带泪的鱼
一生所爱	yoyo,卢冠廷
天边的骆驼	呼斯楞
死一样的痛过	mc梦
红星照我去战斗	李双江
听你说	郁可唯,林凡
飞鸟	满江
有一个人	Syl Chan,Jenny Ho
情非得已	李敏镐
此时此刻	许巍
The Lazy Song	Bruno Mars
害怕	带泪的鱼
关忆北	宋冬野
下一站天后	Twins
Proud Of You	冯曦妤
求佛	DJ小可
情动	秦时明月
爱不留	张信哲
说唱脸谱	谢津
牛奶歌	七公主
我要的飞翔	许飞
对你爱不完	金池,魏语诺
潇洒走一回	叶倩文
Close To You	Carpenters
走出喜玛拉雅	琼雪卓玛
忐忑	龚琳娜
忘记尘缘忘记你	雷诺儿
亲爱的嫁给我DJ版	何龙雨
安静	周杰伦
八音盒	轻音乐
苦瓜	陈奕迅
品乡愁	高安
Easy Lover	林志炫,萧敬腾
现在	莫龙丹
洪湖水浪打浪	孙滢迎
荡荡悠悠	周云蓬
爱我别走	张韶涵
初秋	林海
江山无限	屠洪刚
爱殇	董贞
忘尘谷	刘珂矣
Maria	金雅中
Lullaby	George Winston
逢场作戏	本兮
별에서 온 그대	Younha
βios	泽野弘之
我要我们在一起	杨宗纬,李泉
空港	戴爱玲
草原恋	降央卓玛
钟鼓楼	何勇
好为仁师	周晋进,励敏
Mirrors	Justin Timberlake
胭脂扣	梅艳芳
再见吧 喵小姐 (Live)	王晓天
让生命等候	童安格
想家的时候	阎维文
祖国万岁	谭晶
酒干倘卖无	彭佳慧,顺子
Back	INFINITE
春风吻上我的脸	凤飞飞
一首情歌	姚笛
这个人已经与我无关	田馥甄
梅花	邓丽君
追	张国荣
사랑이라는 이름으로(以爱的名义)	KEN (VIXX)
打呼	潘玮柏,杨丞琳
狼与美女	EXO-M
心要让你听见	邰正宵
假如爱有天意	卡洛儿
完美的再见 (Good bye my love) (Inst)	Super Junior-M
冻结	林俊杰
遇见你是我的缘	高胜美
剑起苍澜	董贞
友情岁月	陈小春
花非花雾非雾	张睿
眼泪的错觉	王露凝
泉水叮咚	杨钰莹
身边	无印良品
平衡	陈琳
爱你	王心凌
一闪一闪亮晶晶	40
黄土高坡	李娜
只要我长大	儿歌
草原情	草原歌曲
冰火	李贵府
Stay	BIGBANG
笑泪	带泪的鱼
没那种命	陈小春
布列瑟农	Matthew Lien
当你老了 (新编)	赵照
Crayon	G-Dragon
静心极乐	空雨
等一个晴天	蔡淳佳
可不可以放弃	程响
Black & Blue	Chris Garneau
不见不散	孙楠
恋人歌歌	胡彦斌
好春光	吴彤
花与剑	Js
那个男人 (Live)	张碧晨
禅院钟声	古筝佛赞
在一起	胡彦斌
FALLINLOVE2NITE	Prince,Zooey Deschanel
雨中慢摇	DJ小可
梁祝	黑鸭子
Wild Child	Enya
山歌好比春江水	斯琴格日乐
错觉	孙燕姿
Falling	张新
爱 开到荼蘼	带泪的鱼
免失志	卓依婷
酒干倘卖无	程琳
火火的姑娘 (合唱)	东方红艳
小丑	潘玮柏
不想懂得	张韶涵
大眼睛	刀郎
爸爸妈妈听我说	小葡萄
绝口不提爱你	郑中基
pretty boy	英文歌曲
说了再见以后	苏打绿
现在我很幸福	A-Lin
雪花红梅	龚淑均
吉祥谣	容中尔甲
唯一	王力宏
嘻唰唰	花儿乐队
想对你说	杨宗纬
我们好好爱	成林江措,嘉央曲珍
天佑女人们你们听好续集	MC
情缘巴士站	谭咏麟
前传	林子祥
天边的骆驼	蒋大为
女儿情	童丽
耶稣掌权	盛晓玫
One Evening (Vv Mix)	Feist
今夜你会不会来	黎明
刀光剑影	郑伊健,风火海
花心	周华健
梦太晚	NULL
孤单背影	陈慧娴
Let's Vogue	吉克隽逸
露馅了吧 (티가 나나봐)	15＆
你的样子	罗大佑
梦醒时分	陈淑桦
我不是高富帅	高山林
Yesterday	Leona Lewis
不如今晚	陈慧琳,郑伊健,梁家辉
你潇洒我漂亮	李玲玉
常回家看看	龚玥
女人何苦为难女人	辛晓琪
\x,$\x0"\x.'\x !\x,$\x0"\x.'\x !	杨梓
雪候鸟	熊天平
枉凝眉	童丽
人间第一情	张也
Mine Mine	周杰伦
Larger Than Life	Backstreet Boys
To Be With You	Mr. Big
神的传说	谭咏麟
你是我的花朵	伍佰
独家记忆(国)	陈小春
Super Duper Fly	张震岳,MC Hotdog,顽童MJ116
晚秋	黄凯芹
Boyfriend	Justin Bieber
爱不爱都铭心刻骨	王新什
鸿雁（复活版）	云杰
全球变冷	许嵩
A Moment Like This（中国梦之声官方指定中文版）	茜拉
Wonderland	24味,卫兰
沧海一声笑	古筝
夜未央	谭咏麟
七秒钟的记忆 - 苏小小	徐良
天涯明月刀	钟汉良
爱的纪念	理查德·克莱德曼
大辫子	王二妮
缠绵游戏	梁汉文
As Long As You Love Me	Justin Bieber,Big Sean
Jingle Bells	Carpenters
被伤过的男人	李贵府
狩猎	胎教音乐
睡公主	邓紫棋
橘子汽水	南拳妈妈
一个人跳舞	张目,周诗颖
Burn	Ellie Goulding
trust	Christina Perri
我的八十年代	张蔷
Take You	Justin Bieber
江山	彭丽媛
Only Time	Enya
Lonely	Akon
葫芦娃 - 主题曲	儿童歌曲
分手再会 (헤어졌다 만났다)	Davichi
在他乡	水木年华
梁山伯与朱丽叶	卓文萱,曹格
光明	汪峰
怎样说清此刻的心情	BY2
路	王杰
辣妹子	宋祖英
喝着烈酒唱情歌	龙梅子
把悲伤留给自己	莫文蔚,陈升
幸福的星星	带泪的鱼
致爱丽丝	聂钧
亲密爱人	梅艳芳
Bamboo Dance	和平之月
忽然之间	炎亚纶
万水千山总是情	纯音乐
I Believe	纯音乐
蝴蝶	刘若英
山水间	玖月奇迹
爱情	莫文蔚
小芳	李春波
情人街	祁隆
帅哥去哪儿	陈梓沫
侠客行--《九阴真经》新资料片主题曲	NULL
小宇宙	苏打绿
我的眼睛在下雨	刘秋仪
童年	儿童歌曲
北戴河之歌	GALA
一生不变	李克勤
拉黑隐身	带泪的鱼
风吹过的街道	钢琴曲
鸟之诗	初音未来
一首简单的歌	王力宏
左半边翅膀	许飞
那年夏天	许飞
阿弥陀佛	佛曲
我只在乎你	DJ小可
还是好朋友	王心凌
锦衣卫	萨顶顶
冻结	孙子涵
非你莫属	Tank
出卖	周传雄
难忘初恋的情人 (国语)	邓丽君
第一时间	F4
Heartbreaker	G-Dragon
Stole	Kelly Rowland
般若波罗蜜多心经	耀一法师
背影	林宥嘉
大高原	乌兰托娅
油菜花开（选自降E大调第九钢琴协奏曲）	莫扎特
Summer	Calvin Harris
偏偏喜欢你	陈百强
春光美	张德兰
为爱痴狂	刘若英,陈升
听他们说	王艺洁
九九艳阳天	宋祖英,吕继宏
知道不知道	韩宝仪
青春纪念册	可米小子
独上西楼	邓丽君
世界名曲	轻音乐
Too Much Between Us	George Winston
小螺号	小蓓蕾组合
似水流年	梅艳芳
我们是共产主义接班人	小蓓蕾组合
太想爱你	张信哲
2010世界杯主题曲	waka waka
我爱的姑娘	李贵府
相见不如怀念	龙飘飘
七号公路	飞儿乐团
旧欢如梦	李克勤
在一起	钟欣桐,胡彦斌
吻得太逼真	张敬轩
一人独得	苏永康
陪着我的时候想着她	郭静
我要给你	庾澄庆,吴莫愁
聪明的一休	小蓓蕾组合
遗失的美好	张韶涵
红楼梦 序曲	郑绪岚
等你等了那么久	男女对唱
海角七号	东来东往
My Humps	The Black Eyed Peas
U Make Me Wanna	Blue
看不清楚的爱	带泪的鱼
等你等了那么久	祁隆,乐凡
慢慢来比较快	梁静茹
牵手	黄绮珊
我爱你中国	韩磊
眼泪	范晓萱
前门情思大碗茶	杭天琪
你最红	2NE1
Day By Day	T-ara
我知道	李琦
对你说	王筝
一无所有	崔健
对不起，我还爱你	回音哥
光阴的故事	张艾嘉
大悲咒	齐豫
Begin Again	Taylor Swift
黄土地上	皆大欢喜
折子戏	黄阅
格子广场	带泪的鱼
战无不胜	陈小春
美丽的心情	宋祖英
疯人愿	魏晨
昨日帝王篇	赵晓磊
替身	张宇
看我72变	胡梦周,王洪迪
Could This Be Love	Victoria Acosta
信仰在空中飘扬	汪峰
失忆蝴蝶	陈奕迅
如此懦弱的我	徐良
报告老板	白客,小爱,子墨,本煜
摇篮曲	勃拉姆斯
中国梦	陈思思
光荣	Bobo
Run Away	本兮
绣荷包	王二妮
小步夜曲	肖邦
使劲摇	芭比
想把我唱给你听（清晰版）	老狼,王婧
草原恋人	乌兰托娅
人在旅途	云菲菲
自由	张震岳
真的汉子	林子祥
爱的代价	梁咏琪
遇到	方雅贤
爱与哀愁	童安格
你走你的路	陈淑桦,李宗盛
那个女孩	陶喆,卢广仲
帝王之恋	李贵府
我爱你,再见	朴树
不是对不起都换来没关系	李贵府
战争世界	苏仨
财神来到我家门	卓依婷
劲爆 - 舞曲 16首 88分钟 连播 伤感音乐空间制造	Dj
一梦千寻	袁泉
星空	林海
情与法	高胜美,左宏元
小永远	何洁
像个孩子	梁博
但愿人长久	邓丽君
房间	刘瑞琦
候鸟	S.H.E
疯狂大麻	DJ舞曲
触电	S.H.E
棒棒棒	黎明,MC
情锁	陈星
有一个美丽的传说	蒋大为
离歌	林志炫
大家一起来	孙悦
美了美了	小沈阳
Walk Away	High School Musical Cast,Vanessa Hudgens
避风港	冯曦妤
I Stay In Love	Mariah Carey
芹菜	林志颖
分手了还是朋友	程响
赶牲灵	阿宝
我的骄傲	杨培安
I Wanna Go	Britney Spears
何必西天万里遥	西游记
小燕子	少儿歌曲
车站	孙露
一个人的天荒地老	张宇
海韵	邓丽君
呼吸(Breath)	Chen,张力尹
爱在深秋	谭咏麟
我们这里还有鱼	谢霆锋,黄大炜,游鸿明,黄中原
白蛇DJ舞曲	李贵府
千山万水	周杰伦
怕你为自己流泪	黑豹乐队
被情伤过的女人	祁隆
La Isla Bonita	Madonna
浅浅的笑	夏后
好想好想	赵薇
即使知道要见面	Sara
其实很寂寞	欢子
等不到的爱	文章
蒲公英的约定	周杰伦
我的眼里只有你	景岗山
难忘今宵	李谷一,张英席,孔子学院
带我走	杨丞琳
One Time	Justin Bieber
铃儿响叮当 - 英文童声版	圣诞歌曲
明天不上班 (feat. 蔡健雅)(live版)	谢帝
南泥湾	郭兰英
我是真的爱他	带泪的鱼
欢乐颂	小蓓蕾组合
爱我（女生版）	袁姗姗
像男人一样去战斗	孙浩雨
忠诚的人妖	NULL
听妈妈的话	轻音乐
Underneath The Tree	Kelly Clarkson
If I Die Young	The Band Perry
梦里花	张韶涵
辛德瑞拉	戴佩妮
橄榄树	刘彩星
最近比较烦	周华健,品冠,李宗盛
指间沙	凤凰传奇
伤害DJ舞曲	李贵府
你懂的	李贵府,乐乐
如果爱能早些说出来	山野
我知道你对我好	乌兰托娅,雅锋
恶作剧	王蓝茵
小小时代	群星
谁见过梦中的草原梦中的河(原创)	降央卓玛
我们可以分手了	李贵府
今夜二十岁(live版)	杨坤
五月天	S.H.E
独立	蜜雪薇琪
一朝芳草碧连天	曹轩宾
一直想着他	庄心妍
这样爱了	张婧
东北人都是活雷锋	雪村
Adagio	Secret Garden
????	零点乐队
意大利舞曲let's go jump around	anry
琉璃锁	郑源
长城	Beyond
不白活一回	毛阿敏
借我一点爱	NULL
爱人	韩旭,阿明
Going Home	Kenny G
快乐你懂的	快乐家族
溜溜的情歌 现代拉丁舞曲版	凤凰传奇
夕阳醉了	张学友
听说爱情回来过	张敬轩
数到五答应我	曹格
蓝色多瑙河(An der schonen blauen Donau, Walzer, Op.314 (The Blue Danube))	卡拉扬,维也纳爱乐乐团
我的皇后	罗志祥
dj - 听了你就开始飘	NULL
我的未来不是梦	胡彦斌
Moon	George Winston
我曾爱过的女孩	李易峰
独处的时候	苏打绿
午夜香吻	韩宝仪
情感的禁区	刘德华
临时演员	黄渤
爱过留情	崔子格,刘雨潼
你是我今生的唯一	艾歌
妈妈的吻	卓依婷
泛滥地	带泪的鱼
天边	乌兰托娅
东方中国龙	李贵府
送别	黑鸭子
第一次	光良
骏马奔驰保边疆	蒋大为
你的样子	齐秦
星星的约会	小虎队
患难见真情	阿清
被情伤过的男人	黑龙
爱的故事上集	孙耀威
等我先说	夏天Alex
何苦要等下辈子	李草青青,肖玄
伤害	李贵府
哭不出来	张惠妹
让我为你唱首歌	俞灏明,魏晨,朱梓骁,张翰
洋葱	丁当
生日快乐歌	英文歌曲
做自己的英雄	樊凡
Truly Madly Deeply	Savage Garden(野人花园)
劳动最光荣	小蓓蕾组合
等待	汪峰
要我怎么忘了他	谢霆锋
浮生未歇	音频怪物
Try	Colbie Caillat
那时候的我们	李贵府
永恒的一天	庾澄庆
遇江南	杨钰莹
后 (후)	J-Min
我爱的姑娘DJ舞曲	李贵府
李雷和韩梅梅	徐誉滕
牧歌	平安
Bad Girls	李孝利
开到荼靡	王菲
闪闪惹人爱	萧亚轩
Everytime	Britney Spears
狂想曲	萧敬腾
我的歌声里(Demo)	曲婉婷
路人	江美琪
给自己的情书	王菲
约定	周蕙
打起手鼓唱起歌	莫文蔚
小号进行曲	群星
草原醉	乌兰图雅
我最亲爱的	筷子兄弟
草原之夜	费玉清
枉凝眉	张也
let it be	The Beatles
拉手手亲口口	云飞
放手去爱	迪克牛仔
分手总要在雨天	张学友
你懂的	李贵府
铿锵玫瑰	林忆莲
读你	费翔
彩云之南	央金
Pieces	SUM 41
我有一只小毛驴	少儿歌曲
火火的姑娘	东方红艳
Honey Honey	孙燕姿
The Magnificent Seven	erich kunzel
其实你不懂我的心	童安格,周治平
天真	弦子
吉祥	云飞
草泥马之歌	未知
前生缘	李贵府
爱你不是两三天	梁静茹
累啊累	王绎龙
如果现在	王麟
爱情怎么喊停	曾沛慈
上马酒之歌	乌兰托娅
雨落长安	金琳
呼儿嘿哟	李春波
白蛇	李贵府
Redneck Woman	Gretchen Wilson
有没有	张靓颖
爱我的人和我爱的人	游鸿明
Change	Sarah Connor
草原上升起不落的太阳	蒋大为
无法逃脱	指南针乐队
叹情歌	高安
森林狂想曲	吴金黛
Love Story	泰勒·斯威夫特
袖手旁观	曾一鸣
乡间的小路	张明敏
国色天香	李玉刚
巴啦啦小魔仙 - 片尾曲 星座 密码 之 奇迹 舞步	大小ann
爱的世界只有你DJ	祁隆
Dj Got Us Fallin' In Love	Usher,Pitbull,Hypercrush
香草吧噗	南拳妈妈
A Thousand Years	Christina Perri
How Deep Is Your Love	Bee Gees
时光的尽头	水木年华
枕边故事	华晨宇
故宫的记忆	神思者
クルマレテ	吉田亚纪子
我终于失去了你	赵传
没离开过	林志炫
Faint (Album Version)	Linkin Park
跳跳糖	丁丁
味道	辛晓琪
Adore You	Miley Cyrus
卡农-摇滚版	Jerryc
你就像个小孩	阿杜
天路	龚玥
我应该去爱你	汪东城
天蓝如海	平安
燃点	胡夏
我和草原有个约定	凤凰传奇
Blossom/Meadow	George Winston
30 SEXY	Rain
全世界最伤心的人 (DJ舞曲)	老猫
Back At One (Live)	余枫
花木兰	Angel Girl
南飞雁	侃侃
不是因为你美丽我才爱上你DJ版	何龙雨
倾国倾城	陈楚生,齐秦
劲爆舞曲 - 强烈推荐韩国舞曲 dj 歌	dj舞曲
串烧 - 11首	周杰伦
别误会	胡彦斌
原来	南征北战,米线乐团
斑马,斑马 (Live)	张婧懿 
都是寂寞犯的错 DJQQ	樊少华
如果时间有回音	沈依莎
星空物语	张翰,俞灏明,魏晨,朱梓骁
妖精尾巴的战斗插曲	妖精的尾巴
用心爱你你不懂	田一龙
只想做你的男人	欢子
记得我曾爱过你	带泪的鱼
哥只是个传说（哥只是一个传说）	陈旭
不要让爱你的人再受伤	李贵府
两只老虎	儿童歌曲
兄弟一条心	郑源,郑东
催眠曲	莫扎特
最心疼的人只有你	张振宇
黑白照	邓丽欣
Beautiful Light	金志文
爱不单行	罗志祥
你不知道的事	范玮琪,鲍丹
Shine Your Way	Owl City,YUNA
一生中最爱的人	艾歌
兄弟情	索朗扎西
思念是一种病	齐秦
第一次听见海	雷蒙拉普
梁祝 「萨克斯演奏」   Saxophone	纯音乐
当我唱起这首歌	小贱,星弟
小苹果（中国风改编）	NULL
无赖	郑中基
祝妈妈长寿	阎维文
遗失的心跳	萧亚轩
Bohemian Rhapsody	Queen
在那遥远的地方	王洛宾
带泪的鱼	带泪的鱼
女儿情	李玉刚
倍儿爽（Remix版）	大张伟
我很想爱他	Twins
赛马	崔子格
爱 什么稀罕	张惠妹
不能分手的女人,不能离开的男人	Lee Ssang
二泉吟	董文华
牧马人	杨坤
For the First Time in Forever	Various Artists
你的眼睛背叛了你的心	张学友
信天游	程琳
Bubbly	Colbie Caillat
你要的不是我	林俊杰
Stay	少女时代-太蒂徐
一个人的北京	山野
走进西藏	李娜
爱情伤了你爱情害了我	大庆小芳
因为爱所以爱	谢霆锋
如果爱能早些说出来	山野
Talking To The Moon	Bruno Mars
燕子	黄灿
李香兰	张学友
活出个样来给自己看	衡越
新打工谣	陈星
恰似你的温柔	蔡琴
我的心是暖暖的	樊凡
画情	姚贝娜
我爱的人	陈小春
Love In December	Club 8
爱过的你还在我心里	尹熙水
不管有多老	何真真
The Diva Dance	贵族乐团
安妮的歌	Bandari
天池	李玉刚
野风	林忆莲
爱你在心口难开	萨克斯
Childhoood Memory（儿时记忆）	Bandari
小路	邓丽君
不枉爱一场	徐申东
Alice	Avril Lavigne
苦果	程响
小情歌	苏打绿乐团
纯情	高耀太
我是不是该安静地走开	李玲玉
寻水的鱼	许飞
卖火柴的小女孩	刘美麟
十送红军	黑鸭子
maria arredondo maria arredond	Burning
布拉格广场	蔡依林,周杰伦
天之大	毛阿敏
祝福祖国	汤灿
再回首	李宗盛
疯狂舞台DJ	任军太
你怎么舍得我难过	胡彦斌
Ce Frumoasa E Iubirea	Giulia
北京的金山上	徐林,六弦
芙蓉小镇	NULL
北京的金山上	胡彦斌
Jewel	滨崎步
虫儿飞	屯门儿童合唱团
走向复兴	群星
Heritor	韩国原声带
三百六十五个祝福	蔡国庆
越来越不懂	蔡健雅
爱与不爱之间	回音哥
真我的风采	刘德华
一亿个伤心	网络歌手
一剪梅	降央卓玛,费玉清
我不配	周杰伦
Beauty And A Beat	Justin Bieber
小星星	汪苏泷
想唱就唱	张含韵
自虐	张惠妹
E Penso a te	Richard Clayderman
红玫瑰(国)	陈奕迅
心似狂潮	羽泉
The Windmills Of Your Mind	Dusty Springfield
再说一次我爱你	刘德华
少年壮志不言愁	李泽坚
百鸟朝凤	唢呐
康定情歌	王拓
삐딱하게 (Crooked)	G-Dragon
身披彩衣的姑娘	刀郎
新年快乐	卓依婷
夕阳醉了	张学友
All About You	Hilary Duff
像男人一样去战斗 - 加快 5倍	DJ
Morning	卫兰
Coming Home	Diddy Dirty Money
水墨缘	玖月奇迹
无所谓 (My Love For You)	Super Junior-M
不知不觉	小贱
同类	孙燕姿
我不愿让你一个人	五月天
10 minutes - 韩国歌曲	李孝利
Music	Madonna
请把我在路上叫醒	汪峰
我爱的人	林宥嘉
好听	许茹芸
蓝精灵之歌	儿童歌曲
Don'T Wanna Go Home	Jason Derulo
随缘	温兆伦
她	王馨悦
原来	林俊杰
Fighter	Christina Aguilera
故乡梦	容中尔甲
明明白白我的心	陈淑桦,成龙
GOOD爱	欧弟
天黑黑	张学友
风继续吹	张国荣
出卖	那英
如果这都不算爱	伍佰
女儿情	龚玥
英雄寞	郑中基
The Lazy Song	Bruno Mars
My Oh My	Aqua
When You Say Nothing At All	Ronan Keating
怨苍天变了心	方季惟
欢聚一堂	刘和刚
burning gold	Christina Perri
我今天为你祝福	基督教歌曲
过了很久	白智英
逆风的蔷薇	弦子
只想凝视着你卡通片尾曲	灌篮高手
原来的我	齐秦
慈祥的母亲	降央卓玛
The Shadow (inst)	宝儿
飘洋过海来看你	梁静茹
我是女生	徐怀钰
听袁惟仁弹吉他	S.H.E
你懂不懂爱	唐古
过河	潘长江,刘春梅
梦里的天堂	皆大欢喜
雪之花	朴孝信
飞羽	董贞,崔岩
你把我灌醉	沙宝亮
阿佤人民唱新歌	黑鸭子
永远	郭峰
漂流	张恒远
闯码头	大哲
与声音跳舞	谢天笑
关不掉的月光	庾澄庆
姑娘像花一样	安东阳
时间都去哪儿了(live版)	王铮亮
별에서 온 그대 (来自星星的你)	Younha
Crazy Kids	Ke$ha
绽放	李健
恋爱达人秀	崔子格,老猫
危险世界 (iTunes Session)	方大同
爱在深秋	谭咏麟
一天(A day without you)	JONGHYUN,Chen
愚公移山	江涛
火影忍者最新主题曲 ブル バ ド 青鸟 完整版	佚名
傲慢的上校	朴树
??????????	吴贞
抱紧我(电视剧《千金归来》片头曲)	李沁
连续剧	容祖儿
逝去的诺言	陈慧娴
当爱已成往事	曾一鸣
Born To Die	Lana Del Rey
姑娘姑娘我爱你	阿牛
新年快乐	小虎队,忧欢派对
Tell Me	潘玮柏
小松鼠过河	儿歌
翻身道情	王二妮
爱我的人和我爱的人	迪克牛仔
老婆是天	云菲菲
拾忆	张翰
羞答答的姑娘我爱你 吉特巴	李贵府
清净法身佛	齐豫
尘缘	罗文
分手了还是朋友 - 原版伴奏	程响
心中的日月	王拓,叶秉恒
Take Me Home Country Roads	小野丽莎
新鸳鸯蝴蝶梦	黄安
走进新时代	卓依婷
隐隐约约	许嵩
不想让你哭	王强
crossing field	织部里沙
小莫骚麦	NULL
我爱你 (너를 사랑해)	尹美莱
离别赋	周华健,张大春
A.I.N.Y.（爱你）	G.E.M.邓紫棋
对她好一些	艾歌
长路漫漫任我闯	林子祥
一事无成	周柏豪,郑融
无辜	曹格
不配说爱我	常艾非
The One You Love	Glenn Frey
不是爱	吴莫愁
爱的华尔兹	俞灏明,郑爽
追梦人	罗大佑
八月照相馆	李健
Run Devil Run	少女时代
好大一棵树	田震
十五的月亮	董文华
Butterfly	Smile
中华民族	张明敏
爱的就是你	刘佳
红梅赞	卢雪梅
想起	江美琪
Love Runs Out	OneRepublic
绿光	孙燕姿
Can You Feel It	Jean Roch
红旗飘飘	孙楠
红茶馆	陈慧娴
一万个女人	杨坤
南海姑娘	邓丽君
river flows in you (在妳身上流动的河)	李闰珉
直到世界的尽头	Wands
清晨的紫禁城	李志辉
听不到	梁静茹
为了谁	祖海
真的汉子	林子祥
南山忆	许嵩
我和你	邓丽君
Loving You	Michael Jackson
爱上你的美	张忆亚,常颖
好想好想	古巨基
双人床	艾歌
你寂寞才找我	陈娟儿
Numb Encore	林肯公园,Jay-Z ,德瑞博士,50美分,艾米纳姆
一世情缘一世愁	陈瑞
假行僧	崔健
美丽的草原我的家	龚玥
你的所有瞬间 (Piano Ver.)너의 모든 순간	成诗京
天鹅湖	理查德克莱德曼
Partita For Double String Orchestra: Iv. Fantasia (Allegro)	吉克隽逸
一肩之隔	秦岚
我就在你面前	金池
下辈子不要再遇见你	艾歌
活着	任贤齐,莫文蔚
闪亮的日子	罗大佑
傻女	陈慧娴
女人的美	龙梅子
草原舞曲	阿宝,张冬玲
可爱的蓝精灵	小蓓蕾组合
Wait A Minute	少女时代
下一首悲哀	单色凌,梦岚
苦乐年华	李娜
桃花谣	谭晶
小心小心	崔子格
那些花儿	范玮琪
隔世离空的红颜	侃侃
我很想爱他	林俊杰
没有感情的感情	艾歌
奔跑+冷酷到底	羽泉,邓超
我们的歌谣 萨尔萨舞曲版	凤凰传奇
小白兔	儿童歌曲
摇啊摇摇到外婆桥	小蓓蕾组合
闯码头	DJ小可
it is my life	bonjovi
带走	莫艳琳
南无观世音菩萨圣号	佚名
Count On Me	Bruno Mars
No Promises	Shayne Ward
曾经的爱	正月十五
回来	黄绮珊
于谦 - 郭德纲于谦 禁播相声 小段	郭德纲
英雄联盟	乱感觉
听妈妈讲那过去的事情	小蓓蕾组合
无家可归的人	汪峰
我的祖国	刀郎
等你的季节	吴奇隆,刘诗诗
知己，自己	郑伊健,风火海
美丽中国	徐千雅
遇	AiMiNi
问	范玮琪,胡维纳
你不配	谢容儿
马航去的地方	马健南
The Rose(extra ver.)	手嶌葵
爱要怎么说出口	赵传
等你一万年	杨钰莹
想念你	萧敬腾,贾剑龙
Ring Ding Dong	SHINee
白头到老	金木
爱情美酒分给谁	龙梅子,老猫
太贪心(Blind)	周觅
乡恋	李谷一
红蔷薇	丽江小倩
Try	P!nk
草原请你来	蒙克
在世界之巅呼唤爱	崔子格
彼得潘	EXO-M
约定	王菲
岁月无声	Beyond
叫你一声My Love	小虎队
各自远飏	中孝介
坐上火车去拉萨	徐千雅
神话情话(粤)	周华健,齐豫
Someday I’ll Fly	G.E.M.邓紫棋
Creep	Radiohead
爱情一阵风	闽南语歌曲
葡萄成熟时	陈奕迅
Amazing Grace	Hayley Westenra
迷宫	王若琳
爱如空气	孙俪
那女孩对我说	黄义达
拆东墙	许嵩
今生今世	张杰
夏夕空	中孝介
我爱的你却给她披上了嫁衣	艾歌
Take My Hand	Simple Plan
故乡	塔斯肯
欢颜	平安
观音灵感真言	NULL
Dope	Lady Gaga
心雨	高胜美
We Will Rock You	Paul Rodgers,Queen
女汉子	周艳泓
吻	萧亚轩
天地在我心	吉克隽逸,刘欢
江湖再见	胡彦斌
爱与愁	伍思凯
冬天里的白玫瑰	地铁兄弟T&T
越爱越难过	吴克群
大悲咒 - 梵音原唱慈悲版 mp3.1	佛教音乐
包子铺（流行风趣版）	赵世林
难以抗拒你容颜	张信哲
友情岁月	郑伊健
32号嫁给你	樱子
等一分钟	徐誉滕
空城	杨坤
蜗牛与黄鹂鸟	杨沛宜
好久不见	彭佳慧
一定要爱你	孙露
三天三夜	歌浴森
牵挂你的人是我	高林生
一个人的脚步	艾歌
小小葫芦娃	小蓓蕾组合
天神纪	茜拉
I Can't	2PM
以父之名	周杰伦
全世界都知道你变了心	艾歌
坏女孩	梅艳芳
爱如空气	孙俪
世间始终你好	罗文,甄妮
花雨	具惠善
男孩别哭	海龟先生
我不会爱	萧敬腾
孤枕难眠	周华健
相亲相爱一家人	李霄云,陈翔
难念的经 - 经典著作 天龙八部主题曲	周华健
为你我受冷风吹	胡彦斌
大敦煌	刀郎
我还有点小糊涂	刘晨
问剑 	NULL
A Little Inspiration	Jo De La Rosa
爱现在的我	G.E.M.邓紫棋
拍手歌	儿童歌曲
She Came To Give It To You	Usher,Nicki Minaj
Break Free	Ariana Grande
你懂得	李贵府
天使宝贝	胎教音乐
想起你的好	杨钰莹
太过爱你	戚薇
懂事	孙燕姿
一万个舍不得	庄心妍
爱如空气	孙俪
Through The Wire	Kanye West
神秘嘉宾	林宥嘉
微光	苏打绿
江之南 葫芦丝	钟心
美好的	许哲佩
Harder Better Faster Stronger	Daft Punk
姑娘我铁了心跟着你啦	龙梅子,老猫
如果这就是爱情	张靓颖
站在高高的山岗上	正月十五
I'M Gonna Getcha Good!	Shania Twain
幸福	毛阿敏
Find The Way	中岛美嘉
口弦(电视剧《听见凉山》插曲)	赵艺涵
回家真好	刘德华
且行且珍惜	张信哲
忘记时间	胡歌
嗨嗨人生	Mc Hotdog,张震岳,关颖
다시 만난 세계(再次重逢的世界）	少女时代
When You Say Nothing At All	Alison Krauss
你怎么舍得我流泪	艾歌
比我幸福	陈晓东
水姻缘	田震
Never Had A Dream Come True	S Club 7
大哥	卫兰
夏日华尔兹(Summerwaltz)	Bandari
传说中的天堂	艾歌
死去活来	王绎龙
Last Of The Wilds	Nightwish
Bounce	Sarah Connor
水手公园	GALA
我的爱只给你一个	艾歌
Vincent	Don Mclean
彩云追月	龙飘飘
天籟之爱	萨顶顶
Bonfire Heart	James Blunt
吉祥	春雷
围绕	孙燕姿
爱江山更爱美人	李丽芬
酒干倘卖无	那英
慢摇低音炮	DJ
动物园	马飞
从头再来 - 重头再来	刘欢
春野	Bandari
놀러와	miss A
雪人	范晓萱,王力宏
扭一下	艾歌
Fairy Tale	Toni Braxton
求佛	誓言
淋雨一直走	陈思霓
让我照顾你	五月天
相见恨晚	彭佳慧
让我们荡起双桨	青春美少女
没有明天 (내일은 없어)	Trouble Maker
校花	庞龙
小老鼠上灯台	小蓓蕾组合
给所有知道我名字的人	赵传
像青春一样怒放	水木年华
于谦 - 于谦泡澡	郭德纲
秋千下的小黄狗	安与骑兵
渔光曲	纯音乐
万山之巅	徐千雅
穿过生命散发的芬芳	侃侃
疼你的责任	品冠
还是好朋友	梁静茹,古巨基
爱了就爱了	陈琳
梦向何处寻	邓丽君
感同身受	林宥嘉
我叫纠结伦	苏三
爱你一万年	刘德华
征服	歌浴森
洗衣歌	韩红
我是一条小河	郭欢
错过	王铮亮
玉生烟	七朵组合
五百年桑田沧海	龚玥
合久必婚	李克勤
相思风雨中	张学友,汤宝如
我比从前更寂寞	杨坤
曾经爱过你	郑源
姐是老中医 专治吹牛逼	佚名
星座书上	许嵩
擦皮鞋	洋洋
有多少爱可以重来	迪克牛仔
摇篮曲	胎教音乐
Pretty Boy (魅力男孩)	泰民,KAI (EXO)
千万次的问	刘欢
跪羊图	网络歌手
Boys Boys Boys	Lady Gaga
胡琴说	汤非,王莉
不是你的错	丁当
因为爱你戒了烟	祁隆
在我生命中的每一天	成龙,苏慧伦
放弃治疗	陈奕迅
漂在北京	汤潮
声声慢	邓福如
我想我不够好	回音哥
分手假期	钟洁,Hojo
跳到北京	祁隆
Spirited Away - One Summer'S Day	久石让
再见——警察	冯曦妤
西游记	小蓓蕾组合
30 Sexy	Rain
最美	羽泉
我不想说再见	白雪
找自己	陶喆
月半弯	陈坤
太疯癫	刘恺威
告别	王城
미치게만들어(让人疯狂)	金孝琳
皇冠一刻钟	DJ舞曲
Amen	戴佩妮
怀念过去	沈丹丹
我用胡琴和你说话	董文华
耶耶耶（中文DJ版精彩）	杨洋,金彪
两个人不等于我们	NULL
哇咔哇咔 - 非洲时刻 m 39s	世界杯主题曲
08 - 时间都去哪了	NULL
绿袖子	理查德·克莱德曼
我的爱人不要走	龙梅子
月满西楼	蔡琴
첫 눈 (The First Snow)	EXO
Love Paradise	陈慧琳
真的爱你	Beyond
再见 (안녕)	孝琳(Sistar)
容易受伤的女人	陈慧娴
一生有你	水木年华
Get Down (You'Re The One For Me)	Backstreet Boys
Stand By Me	葛泓语,张珈铭
不见长安	河图
在天亮前离开	孙思怡
Only Love 只有爱	Trademark
温柔与霸道	群星
Paradise	Coldplay
摩天轮(舞曲版)	罗百吉,宝贝
好兄弟	庞龙
放开	爱乐团
月光下的情思	央金兰泽
无法忘记	黑龙
We Belong Together	Mariah Carey
小镇姑娘	胡彦斌
吻别(国)	张学友
Numb (Live In Texas)	Linkin Park
魔鬼中的天使	庄心妍
出神入化	飞轮海
淘汰(国)	陈奕迅
我在乎的是你	六哲
来吧	韩红
爱	小虎队
往事	孟庭苇
我在念着你我的爱人	央金兰泽
白龙马	林一佳
欢喜就好	网络歌手
吹眼睛	庞龙
Beautiful Ones	Suede
谁料皇榜中状元	卓依婷
下马酒	草原歌曲
今夜二十岁	杨坤
放手DJ版	何龙雨,傅潇莹
海阔天空	Beyond
小提琴独奏	加勒比海盗
全新精选慢摇串烧	AaRON
千里之外	周杰伦,费玉清
两个人的烟火	黎明
过不去	张惠妹
舌尖上的爱情	大庆小芳
I Will	bianca ryan
Sunflower	少女时代
真的不容易(DJAlex.x Mix Version)	庄心妍
苦苦挽留	六哲
下一站天后	Twins
男人就是累	陈玉建
沂蒙山	谈芳兵
Drunk In Love	Beyonce,Jay-Z
雪殇	郑源
爱情陷阱	谭咏麟
漂亮的姑娘就要嫁人啦	龙梅子,老猫
思念是一种病	Robynn&Kendy
回不去的温柔	孙浩
不死之身	林俊杰
甜甜的小妹	陈雅森
玫瑰人生	苏菲·玛索,刘欢
哎呀	王蓉
Forever	吴建豪
烟火	吴奇隆
男人不能惯	赵奕欢
你的长发（葫芦丝版）	张挥
苦瓜	陈奕迅
百年孤寂	王菲
Beautiful World	Westlife
Where Did U Go	邓紫棋
Ace (王牌)	泰民
竹林深处(葫芦丝)	纯音乐
为你跑成罗圈腿	阿宝
换掉	李贞贤
别说我的眼泪你无所谓	郑源
如果不能好好爱	吴克羣
青春日记	沙宝亮
老中医	花粥
印象西湖雨	张靓颖
我爱你 中国	汪峰
One Last Time	Kelly Mack
独唱情歌	Tank,Selina
且试天下	墨明棋妙
春天花会开	任贤齐
吻别 (国)	张学友
化蝶	纯音乐
爱上未来的你	潘玮柏
我也很想他	孙燕姿
青藏高原	纯音乐
Sailing	Rod Stewart
我	王杰
兰若词	刘亦菲
没理由	BY2
不分手的恋爱 - 网络歌手 完美版	汪苏泷
Mascara	邓紫棋
雅鲁藏布江	乌兰图雅
也许在	孙楠
恰似你的温柔	邓丽君
亲亲我	幼儿歌曲
龙卷风	G.E.M.邓紫棋
分手就分手	小山
多少柔情多少梦	陈慧娴
I Believe	我的野蛮女友
笑傲江湖	王菲,刘欢
爱情没有那么美	张玮伽
我一直走	郭富城
呼伦贝尔大草原	乌兰托娅
3-7-20-1	王洪迪
你把我灌醉	张赫宣,黄大炜
梦的翅膀受了伤	蒋雪儿
长痛不如短痛	汤潮
你不在	王力宏
乱世佳人	群星
如果有来生	谭维维
海韵	邓丽君
月光	胡歌
光	刘若英
Sweet Dream	张娜拉
咱们从小讲礼貌	小蓓蕾组合
不了了之	冰淇
陪月亮不孤单	龙梅子
天后	回音哥
花满楼	李玉刚
快乐宝贝	青春美少女
你們要赞美耶和华 	赞美之泉
风中奇缘	西单女孩
时间都哪儿去了 - 主题曲	王铮亮
父亲	崔京浩
爱着你却伤了她	冷漠
共产党来了苦变甜	刀郎,云朵
一路的歌唱	张冬玲,阿宝
Love Motion	李敏镐
你是我今生的唯一 - dj 高品质	艾歌
食为天	小沈阳
说再见不应该在秋天	栗雅馨,王子月
喜欢	张悬
不离不弃	艾歌,丁童
蓝色多瑙河 - 钢琴名曲	轻音乐
童话 - 钢琴轻音乐 伤感音乐	钢琴曲
圆梦	衡越
鸿雁(蒙语)	额尔古纳乐队
爱你十分泪七分	裘海正
爱的初体验	张震岳
Slave to the Rhythm	Michael Jackson
承诺	陈翔
相爱的理由	艾歌,晨熙
错误的相遇	徐洁儿
Love On Top	Beyonce
学不会	林俊杰
疯人愿	魏晨
当你的秀发拂过我的钢枪	小曾
That Place In Your Heart	Ronan Hardiman
我就是最爱你的人	黑龙
你快乐 (所以我快乐)	王菲
Hero	Mariah Carey
XO	Beyonce
流浪歌	迟志强
사랑에 베이다	July
你的承诺	泳儿,海鸣威
사랑이 멎지 않게 (Raining Spell For Love)	Super Junior
原来爱情这么伤	梁咏琪
对不起,我爱你	1983组合
阿里郎	阿里郎
催眠	胡海泉,陈俊豪
圪梁梁	云飞
做你的爱人	谢军
愿得一人心 - 雨宗林	李行亮
完美世界	水木年华
冰封(电影《冰封：重生之门》主题曲)	NULL
希望	陈慧琳
哈巴狗	小蓓蕾组合
Good Kisser	Usher
谎言 (거짓말)	BigBang
找一个相爱的理由	艾歌,奥迪
琴韵禅音	霹雳英雄
ニワカアメ	花たん
Anywhere Is	Enya
走出你的世界我更寂寞 DJQQ	樊少华
Rage Your Dream	Move
过眼云烟	文杰
爱一回伤一回	吕方
California Dreaming	North
咱们屯里的人	赵本山
我说我爱你	刘嘉亮
东南西北风	李玲玉
最后的倾诉	韩磊
忘尘	黄龄
天边	廖昌永
花香	许绍洋
涛声依旧	李行亮
来自星星的你 (별에서 온 그대)	Younha
无尽空虚	Beyond
爱那一句话 (사랑 그 한마디)	金泰妍
TVエンディングテーマ	和平之月
보름달	宣美,Lena
她 (Live)	王思远
摇摆.Remix1	蔡妍
结局后才明白	乔洋,X-girl
谁为谁流泪	韩宝仪
萤火虫的梦	艾歌
在一起	羽泉
你的香气	郭静
Supermassive Black Hole	MUSE
红灯记-雄心壮志冲云天	关怀
爱死了昨天	李慧珍
不再犹豫	Beyond
张三的歌	李寿全
Rolling In The Deep	黄鹤
Angel	Westlife
Viva La Vida	Coldplay
一生中最爱的人	艾歌
人生就是一场梦	艾歌
对你怀念特别多	龙飘飘
东方之珠	周华健,娃娃,李宗盛,潘越云,赵传,陈淑桦
爱的期限	祁隆
距离	林俊杰
勇敢的狂奔 - 与狼共舞片尾曲	老猫
To Be With You	Westlife
暴风一族	张国荣
主是我力量	基督教歌曲
我想找个女朋友	姜玉阳
男人女人	许茹芸,阿穆隆
Hands Up	2PM
长安长安	梁博
如烟+如果还有明天	五月天
英雄路	黑龙,成奎安
Innovation Is Fashion	吉克隽逸
Nothing'S Gonna Change My Love For You (Album Version)	GEORGE BENSON
悲しみはオーロラに	Aimer
We Are One (Ole Ola)	Pitbull,Jennifer Lopez,Claudia Leitte
查拉图斯特拉如是说	群星
Break Down	Super Junior-M
西部放歌	王宏伟
我爱的女人	黑龙
Longing/Love	George Winston
来生再做你的人	艾歌
今生相爱	泽尔丹,扎西措
七月初七	黑龙
如花	河图
We Didn't Move A Muscle	ANT
秋天的童话	张杰
油菜花	成龙
一个人的北京	好妹妹乐队
不哭	王心凌
三个人的晚餐	王若琳
爱情曾来过	刘恺威
命运	钢琴曲
千方百计	魏晨
少年	光良;曹格
爱天爱地	黎明
让她降落	何璐
十七岁的雨季 (Live)	杨钰莹,林志颖
Crush	2NE1
Can You Feel My World	NULL
贫民百万歌星	Mc Hotdog
后会无期	徐良,汪苏泷
涛声依旧	毛宁
情侣装	许嵩
一人一花	阿朵
真的爱你	Beyond
来不及说爱你	张靓颖
又唱浏阳河	宋祖英
又见老情人	高安,马睿菈
人海中遇见你	林育群
偏偏遇见你	艾歌
为了你,为了我	Beyond
火火的姑娘 - 吉特巴 高音质	东方红艳
对不起谢谢	陈奕迅
兄弟	金志文,杨坤
Jambalaya	小野丽莎
离人	张学友
Beautiful	Akon
谁先得到幸福	张睿
相爱的理由	艾歌
每个人都会	方大同
外滩十八号	袁成杰,戚薇
裙下之臣	陈奕迅
阿瓦尔古丽	云飞
做你的雪莲 - 吉特 阳光制作	艾歌
人间正道是沧桑	韩磊
为爱而活	张韶涵
泉水叮咚响	二胡独奏,轻音乐
如果可以不爱你	艾歌
最浪漫的事	秦立巍
You Raise Me Up	Secret Garden
你是我的温柔	刘德华
无法原谅	李佳璐
最后一个情人	赵真
醉乡	呼斯楞
东方之珠	罗大佑
Set Fire to the rain（声动亚洲）	茜拉
敢问路在何方	西游记
寻找天堂	艾歌
我爱这蓝色的海洋	许鹤缤
孽子	周旖喆
17	Avril Lavigne
倍儿爽 （春晚版）	大张伟
关于我爱你	张悬
你怎么舍得我流泪	艾歌
Scream	Usher
If I Could Tell You	Yanni
Me And My Broken Heart	Rixton
萤火虫	伊能静
礼物	刘力扬
沉睡的野兽	杨培安
做你的雪莲 - dj 良少 2013 - mix	艾歌
我以为	王浩燃
给抱着盒子的姑娘	宋冬野
Hand Hold	曲婉婷
扔猫 - 郭德纲于谦相声	郭德纲,于谦
传说中的天堂 - dj慢摇嗨曲	艾歌
你一定很爱他	黑龙
La Vie En Rose	Louis Armstrong
万家灯火	艾歌
诀别诗	胡彦斌
讲文明懂礼貌	儿歌
我所幻想的未来	刘明辉
舞台	艾歌
我以为	胡彦斌
最美丽的时候	艾歌
只有你	黄绮珊
你给我的爱还在不在	欢子,韩小薰
Take Me Home, Country Roads	John Denver
你看不到的天空	蔡旻佑
芳华绝代	梅艳芳,张国荣
Life Is Like A Song	曲婉婷
幻想家	庄心妍
希望你懂我	郑源,郑东
做你的雪莲 - 吉特巴 海棠 试听	艾歌
老男孩 - 我一定要得到你	筷子兄弟
做你的雪莲 - wo99.com 消音 bz - 637661	艾歌
Back Hug (백허그)	少女时代
幸福的起点	李代沫
对面	陈奕迅
一个人的脚步 - 2011 - house	艾歌
Vida (官方中文版)	Ricky Martin,金贵晟,李尚尚,隔壁团,林育群,刘伟德,林奕匡
如梦令	杨钰莹
老情歌	吕方
身不由己	何洁
共同度过	张国荣
傲包相会	刀郎
逃	朱克
新滚滚红尘	郑源
传说中的天堂 - 劲爆 dj - dj 版	艾歌
我们在改变	魏晨
Wish I Had An Angel	Nightwish
笑傲江湖琴箫合奏 - mp3 8 电影金曲	笑傲江湖
我不够爱你	刘德华,陈慧琳
Roll The Dice (Demo)	高姗
一帘幽梦	费玉清
U	Super Junior
盛夏的果实	莫文蔚
能不能	李玟
我怀念的	李代沫
安静	周杰伦
瘦瘦的	梁静茹
无常	田馥甄
谎言	g-dragon
渡情 - 片尾曲 西湖美景	新白娘子传奇
十不该	迟志强,张秀艳
Careless Whisper	George Michael
She's Gone	Steelheart
风中有朵雨做的云	孟庭苇
地藏经	佛教音乐
Beautiful People	Chris Brown,Benny Benassi
Can’t Hold Us	Macklemore & Ryan Lewis
九月九的酒	陈少华
小蛮腰	NULL
半岛铁盒	周杰伦
分手了别来打扰我	孙露
情人劫	老狼
与爱为邻	范玮琪
月圆花好	韩宝仪
指纹	胡歌
mary had a Little lamb	小蓓蕾组合
一只蝴蝶	安东阳
执迷不悔	范玮琪,胡维纳
伴	黄小琥
青藏高原	阿宝
Because Of You	Ne-Yo
练习	刘德华
胭脂泪	阿悄
Bang Bang	Jessie J,Ariana Grande,Nicki Minaj
掌声响起	梁静茹
做你的雪莲 - 广东茂名阿河 dj慢摇嗨曲	艾歌
微信惹的祸	张可儿
我的路	汪峰
碌卡	陈奕迅
金缕衣	董贞
寄生	吴克群
爱无罪	迪克牛仔
爱逝.枷锁	带泪的鱼
谁将平生葬倾城	NULL
jami soul she - feat mr.bang annie	萨克斯
只有你	黄绮珊
爱情美酒	龙梅子,老猫
Turn Down For What	DJ Snake,Lil Jon
你得娶我	郭德纲
Chasing pavements	Adele
倾城	许美静
绝世小受	漠然
异乡人	李健
一场游戏一场梦	王杰
后知后觉	张惠妹
雪撬	胎教音乐
天马行空	郝云
耶咯耶	张玮
都是为了爱	门丽
达尔文	蔡健雅
Tik Tok	2PM
向幸福出发	带泪的鱼
内疚	陈奕迅
再见了大别山	刘和刚
妹妹的酒	李泽坚,司徒兰芳
就是我	林俊杰
兵哥哥	宋祖英
婴儿	陈倩倩
男人再晚也别忘了回家	贺一航
镜花水月	李玉刚
游戏人间	郑智化
秋歌	小沈阳
让她降落	田园
Set Me Free(放过我)	TAEYEON
Amarantine	Enya
大悲咒童声版	佛教音乐
你是我的罗密欧	陈兴瑜
昨夜	陈瑞
Somewhere I Belong (Album Version)	Linkin Park
想说爱你不容易	王志文,江珊
金秀贤 - 相爱不可以吗 韩剧 Dream High 插曲 清唱版	金秀贤
火鸟	张杰
梦醒时分	迪克牛仔
Chicago	Michael Jackson
我是一棵秋天的树	张雨生
有点甜  (feat.  BY2)（网游《萌三国》主题曲）	NULL
百万个吻	陈明真
太聪明	陈绮贞
摘下满天星	郑少秋
Runaway Baby	Bruno Mars
遇见我	曹方
好朋友只是朋友	郁可唯
别再问我什么是迪斯科	张蔷
葫芦丝-新白娘子传奇插曲	佚名
未完成的爱	龙梅子
感谢	龙井说唱
晴雯歌	郑绪岚
当我想你的时候	陈明
恋曲1990	罗大佑
燃烧翅膀	樊凡
Untouchable	Taylor Swift
烟花三月	童丽
一帘幽梦	萨克斯
寒衣调	河图
月满西楼 - m45639 慢四	邓丽君
儿歌	张悬
御剑江湖	NULL
Be With You	Akon
我不是黄蓉	王蓉
不只是朋友	黄小琥
La La La	Shakira,Carlinhos Brown
为什么你背着我爱别人	许志安
白骨精写给孙悟空的信	周艳泓
我等你	刘若英
醉梦仙霖古筝版试听	NULL
洛丽塔	卓亚君
我着十号	李克勤
自从遇见你	吕雯
失落沙洲	徐佳莹
黄河大合唱	张真
明天我要嫁给你	黑豹乐队
Give It To Me	Sistar
山丹丹花开红艳艳	阿宝
I Miss U	本兮
往日时光	呼斯楞
兄弟	高进,小沈阳
回到拉萨	郑钧
这一生回忆有你就足够	关泽楠
爱要有你才完美	那英
连衣裙	宋冬野
Summertrain	Greyson Chance
Fuck You	Lily Allen
斑马，斑马	NULL
浪子的心情	叶启田
傻子才悲伤	朴树
天大地大	郑少秋
是我在做多情种	胡杨林
中国人民解放军军歌	红色摇滚
暧昧	李祥祥
如果再回到从前	张学友
안녕 (再见)	孝琳(Sistar)
思念谁 (Live)	帕尔哈提
夕阳无限好	陈奕迅
La La La	Naughty Boy,Sam Smith
美丽新世界	S.H.E
如果还有明天	信,薛岳,柯有伦
My Happy Ending	Avril Lavigne
乡间小路	蔡琴
醉赤壁	霍尊
迷魂记	王菲
一人有一个梦想	黎瑞恩
Blowin’ In The Wind	Bob Dylan
一个人的时光(新曲)	石进
人来人往	陈奕迅
有些事现在不做一辈子都不会做了	五月天
Venus	Lady Gaga
I.O.I.O	S.H.E
Just Dance	Lady Gaga
拥抱你的微笑	郭静
相信自己	成龙
左右为难	张学友,郑中基
天生一对（DJ版）	天孪兄弟
雨花石 - 石头合唱	李玉刚
忘了哭	张学友
堕落天使	郑智化
Heal The World	Michael Jackson
打住打住	杨梓
走天涯	老猫,杨望
花想容	NULL
Love Somebody	Maroon 5
花的嫁纱	王心凌
恨透你	王馨
月光下的凤尾竹	关牧村
亲爱的	潘玮柏
当你孤单你会想起谁	张栋梁
妈妈的吻	程琳
约定	张学友
Palladio	Escala
有你陪着我	安又琪
你知道我在等你吗	迪克牛仔
Like A G6	Far East Movement
痛快	S.H.E
谢谢你让我这么爱你	柯以敏
经典舞曲	ck
走西口	阿宝
I Will Always Love You	Whitney Houston
光辉岁月 (Live)	陈乐基;张心杰
我和春天有个约会	刘雅丽
Legendary Lovers	Katy Perry
心禁锢	带泪的鱼
不要认为自己没有用	成龙
催眠曲	胎教音乐
弹起我心爱的土琵琶	李双江
小丑鱼	罗志祥
Wastelands	Linkin Park
期待，爱	卓文萱
风姿花传	谷村新司
回家	王杰
我一直以为你知道	赵传
I Love It	Icona Pop
一块红布	崔健
意外	薛之谦
盛夏光年	黑龙
穿越火线	大笑江湖
允许我爱你	张睿
Don’T Turn Off The Lights	Enrique Iglesias
临水照花	晃儿,墨明棋妙
汉宫秋月	于秋旋
月亮惹的祸	张宇
男人哭吧不是罪	羽泉
长江之歌	殷秀梅
Call your name	泽野弘之
你并不懂我	By2
Angels (2004 - Remaster)	Robbie Williams
人在旅途	凤飞飞
Alone (Infinite H)	INFINITE
结了	郝云
So Cold	paula deanda
喜欢你没道理	张韶涵
哭砂	叶倩文
不是我不小心	张镐哲
Requiem For A Tower	Escala
赞歌	乌兰图雅
f(x);D.O. - Goodbye Summer (f(Amber Luna Krystal))	f(x),D.O.
床头床尾	陈奕迅
种太阳	小蓓蕾组合
Funrun	胡彦斌
爱好辛苦	龙梅子,韩松圃
讲不出再见	Beyond
你的眼睛背叛你的心	郑中基
粉墨人生	零点乐队
菊花台	童丽
彩虹的约定	儿歌
万里长城永不倒	叶振棠
Oh!	少女时代
最浪漫的事	赵咏华
两个人的荒岛	S.H.E,周定纬
Desperado	Eagles
古剎夕照	古筝佛赞
村长的新娘	李泽坚
孙悟空	五月天
不够成熟	By2
夜的第七章	周杰伦
北京东路的日子	群星
没得选择	樊凡
哭个痛快	任贤齐
卡农（Canon）	Inishkea
裂缝中的阳光	林俊杰
雕花的马鞍	降央卓玛
Hero	Enrique Iglesias
莲的心事	刘紫玲
If	Bread
小情歌	张惠妹
远方的我在等着你	天堂飘雪
主旋律	陈奕迅
红豆红	俞静
Tell Me	Wonder Girls
归	龙井说唱
爱的迷雾	陈瑞
舞娘	蔡依林
风云	仙杜拉
你的幸福是我们最好的礼物	王铮亮
Gypsy	Lady Gaga
爱拼才会贏	叶启田
那又如何	应嘉俐
再见北极雪	周传雄,陈慧琳
New Day Coming	自然与神思合奏团
雪候鸟	多亮
Hey Oh	Tragedie
后知后觉	张新
Here We Are Again	电影原声
Sometimes	Britney Spears
Enchanted	Taylor Swift
千与千寻	久石让
该装就装	郝云
梦里水乡	龙梅子
真的好想你M	周冰倩
我不想忘记你	郭静
最爱的人	郁可唯
rags to rings	NULL
I Believe	范逸臣
错错错	五月天
孩子对不起 (MV版)	杨子军
我的快乐就是想你	红蔷薇
回心转意2009	黑龙
1234	Feist
一天一点爱恋	梁朝伟
冬季到台北来看雨	孟庭苇
十二道锋味	谢霆锋
堆积情感	邝美云
if you are happy	小蓓蕾组合
倒带	蔡依林
铁血丹心	甄妮,罗文
Nobody	戴荃
我的根在草原	德德玛
海誓山盟亦会分开	本兮
家乡美	汤灿
太阳最红毛主席最亲	李姗殷善音
小白船	小蓓蕾组合
现在你是否已经变了模样	丁亮
坏女孩	徐良,小凌
致命的甜蜜	孙子涵
Lonely	孝琳(Sistar)
可不可以不勇敢	范玮琪
爱从草原来	乌兰托娅
映山红	马达,田雨莫
爱我你怕了吗(独唱版)	姜育恒
往事只能回味	韩宝仪
蒙古人	腾格尔
积木	陈奕迅
无限速	本兮,阿悄
边疆的泉水清又纯	李谷一
Sugar Free	T-ara
错过了缘分错过了你	何龙雨
爱的童话	高安,宋娜
一生中最爱的人	艾歌
耀出色	曹轩宾
英雄的黎明	横山菁儿
烛光	任贤齐
踏浪	卓依婷
梦回西藏	容中尔甲
别说爱情苦	刘德华,梅艳芳
小宝贝乖乖睡觉	小蓓蕾组合
雨爱	杨丞琳
爱上你等于爱上寂寞	那英
你看你看月亮的脸	孟庭苇
西双版纳	黑龙
谁是我的新娘	衡越
一个人生活	林凡
伤不起	郁可唯
老大	李晓杰
原谅我不懂爱	G.E.M.邓紫棋
风云	郑伊健
黑板情书	后弦
在希望的田野上	彭丽媛
曼莉	乌兰图雅
说句心理话	阎维文
爱情证书	孙燕姿
九夏忧伤	带泪的鱼
薇多莉亚的秘密	张惠妹
十二月的奇迹(中文版)	EXO
Da Da Da	王心凌
你幸福我快乐	郑源
不要在我寂寞的时候说爱我	T.R.Y
只是太爱你(国)	张敬轩
茉莉花	小蓓蕾组合
我想我不会爱你	田馥甄
再见爱人	李泽坚
Love Me Again	John Newman
一个人 (feat. 吴青峰)(live版)	黄铃凯
爸爸	汪峰
Young Girls	Bruno Mars
安和桥	NULL
第三十八年夏至	河图
狂流	齐秦
Bo Peep Bo Peep	T-ara
Take me	张根硕
热浪	温岚
最长的电影	周杰伦
慢灵魂	卢广仲
Goodbye Montana - Part 2	George Winston
你怎么舍得我难过	尚雯婕
鱼儿和水	黑龙
么么哒	王麟
一剪梅	胡彦斌,黄小琥
讨债难	李泽坚
一剪梅	费玉清
When You'Re Gone	Avril Lavigne
雨滴	肖邦
我是一只小小鸟	赵露
爱就爱了	陈琳
无间道(广东版)	刘德华,梁朝伟
抱着你	张震岳
等你回来	戴佩妮
天上星星下凡来	胎教音乐
伤了我的眼 (dj 何鹏 mix)	李泽坚
爱不爱我	零点乐队
Islands (岛群)	Super Junior
光彩第二街	龙梅子
爱在深秋	陈慧娴
某某 (新编)	杨坤
走在冷风中	刘思涵
动起来	郭富城
凹凸	梁咏琪
好运来	卓依婷
踮起脚尖爱	洪佩瑜
男人情女人心	龙千玉,袁小迪
上瘾的毒药	李泽坚
你不像她 (新歌)	南拳妈妈
大张伟 - 倍爽儿音乐	NULL
风云2	屠洪刚
相见时难别亦难	李玲玉
造物弄人	冷漠
Missing You	2NE1
Need You Now (需要你)	Henry,HOYA (INFINITE)
飞舞	信乐团,王冰洋
众里寻你	韩红
穿越	皆大欢喜
太湖美	龚玥
我爱的男人变了心	陈娇
你把什么都带着	李泽坚
一世情缘	童安格
英雄谁属	卞留念
把耳朵叫醒	金海心
万水千山总是情	汪明荃
几分伤心几分痴	王杰
爱你还是恨你	龙梅子
爱情好无奈	六哲
花吃泡面男	陆虎
庸人自扰(清晰版)	小虎队
依靠	任贤齐
梅花	邓丽君
Dark Paradise	Lana Del Rey
爱我就放过我 DJ阿圣	子枫
如果可以不爱你艾歌	NULL
把爱交给时间DJ版	何龙雨
美丽的女人最伤人	冷漠
我愿意	曾静玟,丁于
上班上班	李泽坚
我就是你最爱的人	黑龙
一个人的行李	戴佩妮
带我到山顶	中国好声音
There You'll Be	Faith Hill
北京 北京	郝云
【交谊舞慢四】空城 杨坤】年春晚歌曲	杨坤
Two Degrees East, Three Degrees West (Lp Version)	John Lewis
Because Of You	Kelly Clarkson
Timber	Pitbull,Ke$ha
分手以后做个朋友	黑龙
情歌没有告诉你	梁静茹
黑武士	林俊杰
我爱你塞北的雪	殷秀梅
爱情不能当饭吃	李泽坚
往事只能回味	姜育恒
너 아님 안돼 (非你不可)	2NE1
Mugam Sayagi (1993)	Kronos Quartet
十三电音	网络歌手
世界唯一的你	曹格
缘来是你	龙梅子,黄勇
父亲的草原母亲的河	廖昌永
终身美丽	郑秀文
天空之城	久石让
灰色空间	罗志祥
世界末日	周杰伦
别哭了宝贝	皓天
遗失的美好	张韶涵
星象仪	大冢爱
三天	黑龙
小姐万岁	蒋承龙
我们说好的	张靓颖
敖包相恋	大庆小芳
天注定	庄心妍
天使的翅膀	孙露
相亲不相爱	李泽坚
Still Waiting	Sum 41
忘记他	邓丽君
杨柳青	阿宝
iggy azalea - fancy(feat. charli xcx)	NULL
红颜若雪	少司命
半斤八两	许冠杰
Goodbye My Lover	James Blunt
Am I Wrong	Nico & Vinz
序曲：但凡世间无仁义 人人心中有梁山	周华健,张大春
百鬼夜行	音频怪物
韩毒	DJ舞曲
幸福的味道	王麟,东来东往
大风大浪大步走	李泽坚
好时光(电视剧《金玉良缘》主题曲)	霍建华
남자답게 (像个男人)	MBLAQ
蓝眼泪	杨蔓
哆来咪	音乐之声
我和草原有个约定	德德玛
Just Can’T Get Enough	The Black Eyed Peas
本来	山野
一辈子一场梦	张卫健
贵妃醉酒	李玉刚
Tears In Heaven	Eric Clapton
Ooh La La	Britney Spears
无法阻挡	阿杜
好兄弟(伴奏)	黑龙
火火的姑娘 - 东方红艳  dj何鹏remix	DJ何鹏
你给我一片天	成龙
走西口	董文华
magic! - rude	NULL
梅岚梅岚我爱你	王麟
回到起点	董贞
孤身走我路	梅艳芳
留不住你的温柔	李泽坚,司徒兰芳
我的快乐就是想你	陈雅森
爱你的我今天长这样	吴奇隆
爱情约定	李行亮
不能厮守的爱	李泽坚
爱无可救药	艾歌
Rolling Star	Yui
敲痛我的心	歌浴森
缠绵	歌浴森
La Ballade Of Lady & Bird	Lady & Bird
麻花辫子	郑智化
黄昏	周传雄
追梦人	Bandari
三家店-将身儿来至在大街口	于魁智
爱着谁 (Live)	耿斯汉
慕容雪	薛凯琪
自我催眠	周杰伦
New Boy	朴树
爱的世界只有你	祁隆
Mr lovable(中文版)	刘瑞琦
노래할게 (Song For You)	李敏镐
\x 'A?\x 	吴贞
就让一切走远(伴奏)	黑龙
梦回浏阳	玖月奇迹
沉默是金	张国荣
暗涌	王菲
蹦吧啦	DJ舞曲
爱让我们在一起	黑龙
寂寞花火	顾莉雅
人质	权振东
无名花	简红
董小姐	NULL
变心的翅膀	陈明真
再见爱人dj版	李泽坚
小两口	安又琪,吴樾
破晓	魏晨
为你	黑龙
夜照亮了夜	万芳
When We Stand Together	Nickelback
Ma Boo	T-ara
三十三块	郑智化
Numb	Linkin Park
留香	吴奇隆
Ich Will	rammstein
Life For Rent	Dido
策马扬鞭	凤凰传奇
让我们荡起双桨	黑鸭子
屌丝的爱	韩信
香水	谢霆锋
La Cha Ta	f(x)
酷爱	张敬轩
我的大学生活	郭德纲
Track You Down	Sondre Lerche
英雄路	黑龙
Love Love Love	蔡依林
痴情司	何韵诗
一生有意义	罗文,甄妮
凌晨两点半	颜亚涛
不愿放手	黑龙
潇洒小姐	萧亚轩
日记	黑龙
分手以后做个朋友 dj版	黑龙
放下	刘亦菲
飘洋过海来看你	李翊君
Thrift Shop	Macklemore & Ryan Lewis
Feel This Moment	Pitbull,Christina Aguilera
游戏人间	郑智化
别离开我好吗(伴奏)	黑龙
像星 (별처럼)	K.Will
放爱一条生路	那英
Scarborough Fair	Sarah Brightman
舞曲	德国战车,DJ
T.T.L(Time To Love)	T-ara
不怨(电视剧《宫锁连城》主题曲)	袁姗姗
一夜惊喜	范冰冰,李治廷
至少还有你	林忆莲
空城	杨坤
老板难当	NULL
蝴蝶	王菲
远走高飞	李泽坚
北京呼唤你(伴奏)	黑龙
到底是谁伤害了谁	庞龙,郭欢
欢快的轻音乐	轻音乐
今夜我对你想入非非	云菲菲
遥远的她	张学友
一片艳阳天	杨钰莹
情人夜	黑龙
往事只能回味	张帝
相见难别亦难	吴静
红颜白发	张国荣
在梅边	王力宏
我忘了	张赫宣
泉水叮咚响	刘紫玲
爱不到的滋味	黑龙
彩虹的微笑	王心凌
有一种爱叫做不放弃DJ版	何龙雨
都怪太爱你	黑龙
混音热播舞曲 feel alright感觉极好	Angel
为爱逃亡	黑龙
离开	Mc Hotdog,张震岳
月半小夜曲	李克勤
飞机场的10:30	陶喆
布兰诗歌	群星
精舞门	罗志祥
说说爱情	陈玉建
ひとり上手(漫步人生路原曲)	中岛美雪
都市情缘	云菲菲
秋天的期盼	黑龙
那时候的我	刘惜君
Should It Matter	Sissel
最远的你是我最近的爱	童安格
美丽新世界	伍佰
亲密爱人	萧敬腾
冰冷的绝对	李泽坚
红尘情缘 - 铃 副本	高安
廉价的爱情	黑龙
佛在灵山莫远求	NULL
爱我你怕了吗　	姜育恒
射中丘比特	黑龙
The Venice Dreamer: Part Two	George Winston
雪人	范晓萱
Till I Collapse	Eminem,Nate Dogg
村长的新娘 (伴奏)	李泽坚
Scarborouge Fair（声动亚洲）	霍尊
幸福的味道	王麟,东来东往
专属天使	Tank
月光奏鸣曲	贝多芬
爱流沙	李泽坚
素颜	徐良
都怪我	李玖哲
Artpop	Lady Gaga
请别离开我	黑龙
浏阳河2008	周笔畅,李谷一
丫头	王童语
别碰我 - dj 舞曲	劲舞团
吻我吧	萧敬腾
苏维埃进行曲	NULL
Beautiful Times	Owl City
她	朱婧
祝你一路顺风	经典老歌
犯错	顾峰,斯琴高丽
几多愁	邓丽君
遗憾	方炯镔
倾城	许美静
因为是女子	Kiss组合
我爱鲁西西	小蓓蕾组合
大圈圈	安瑞兮
疯狂舞台dj	任军太
正月十五送欢乐	正月十五
我愿意	齐秦
末班车	周传雄
一起老去	薛凯琪,陈意涵,杨子姗
雨花石	李雨_石头
父亲的草原母亲的河	云飞
天空之城（钢琴版）	郭燕
年轻的战场（2014摇滚版）	张恒远
别把自己当成腕	李泽坚
Mean	Taylor Swift
思念	毛阿敏
无言的结局	李茂山
点燃一根烟	林玉英
断羽傲飞	安与骑兵
我和春天有个约会	俞灏明
别在我睡着的时候打电话给我	卢广仲
一千年后记得我	林俊杰
回向偈	李娜
不让我的眼泪陪我过夜	黄绮珊
Smooth Criminal	Michael Jackson
望乡	胡彦斌
中国马	朱贝贝
失去你的黄昏	黑龙
当我老去的时候	刘明辉
夜空中最亮的星	张杰
好听	许茹芸
雪人	王力宏,范晓萱
相思雨	央金兰泽
什么都不管	弦子
爱上你	By2
Don't	Ed Sheeran
水中花	谭咏麟
玛卡瑞纳	海龟先生
你抱着别的女人入睡	孙露
always with me	久石让,钢琴曲
不要在我的伤口撒盐	庄心妍
春秋依然	李泽坚
Shero	S.H.E
新年好	小蓓蕾组合
平安最好	李泽坚
The First Cut Is The Deepest	Rod Stewart
相爱到放弃	祁隆
一起摇摆	罗熙杰
我要去远方	黑龙
想你的夜	信乐团
随缘	原声大碟
似水流年	李健
还没说的话	歌浴森
没那么爱他	范玮琪
薄雾	汪峰
我的老班长	小曾
六字大明咒	龚玥
灰鸟(live版)	灰子
你就是我最想要的人	老猫
出发	纵贯线
今夜你会不会来	黎明
To The Sky	Owl City
爱的太累(dj mix)	黑龙
Down	Jason Walker,Molly Reed
少年呀 (소년이여)	G-Dragon
伤	李代沫
雁南飞	董文华
一追再追	李泽坚
亲爱的我们究竟怎么了	网络歌手
北国之春 - 浪漫萨克斯	萨克斯
壮志在我胸	成龙,李宗盛
十指紧扣	张智霖
天命最高	古天乐
My Songs Know What You Did...	Fall Out Boy
冷雨夜 - 词 黄家强 曲 主唱 黄	黄家驹
伤心泪	陈星
彩虹	许巍
飞鸟	任贤齐
新鸳鸯蝴蝶梦	黄安
长城长	董文华
家	陈绮贞
你的承诺	海鸣威
美丽的家园	李泽坚,李婉僮
Without Me	Eminem
神曲2012	歌浴森
青春告别诗	庞龙
牧人	德德玛
故乡香	钟汉良
紫色烟花	徐一鸣
黑色柳丁	陶喆
Sunshine In The Rain	BwO
御剑江湖	董贞
跟着感觉走	苏芮
一路不变	温岚
追梦人	古筝
唱脸谱	杭天琪
Where Did You Go 2.0(Sam Vahdat Remix)	G.E.M.邓紫棋
朋友別哭	吕方
Not a Bad Thing	Justin Timberlake
不要再来伤害我	张振宇
男人靠得住猪都能上树dj版	张吉
金包银	卓依婷
做你的雪莲	艾歌
今生你作伴	陈慧琳
Good-night Kiss	全孝盛
我想对你说baby	王绎龙
Whataya Want From Me	张玮,Adam Lambert
Sweeter Than Fiction	Taylor Swift
End Of May	Keren Ann
双人舞	潘玮柏
家和万事兴	张也,郁钧剑
真爱	刘牧
亲爱的你怎么不在身边	江美琪
Here With You	Asher Book
昴 -すばる-	谷村新司
宝宝的音符	雷蒙拉普
我和你	邓丽君
我期待	声音乐团
河南	歌浴森
Bad Girl	Marilyn Manson,Avril Lavigne
Heart Attack	EXO-M
你看蓝蓝的天	杨钰莹
一百个放心	张津涤
200	乐童音乐家
行星组曲	群星
秋日私语	理查德·克莱德曼
月出	朱哲琴
分手了别来打扰我	冷漠
别无所求	郑源
中国人	刘德华
对不起，只是忽然很想你	李宇春
2012社会磕	DJ,洪磊,MC
Lemon Tree	苏慧伦
胆小鬼	梁咏琪
步步高	景岗山,林依轮,高林生
无情	胡夏
一亿个伤心	蒙面哥
Guitar Sound	Ronald Jenkees
手放开	李圣杰
hold不住的爱	龙梅子
爱妃	后弦
全世界丢弃了我你也不离开我	带泪的鱼
飞呀飞	龙梅子
在梦中	彭丽丽
岁月无声	Beyond
我的祖国	郭兰英
五百年桑田沧海(游戏《斗战神》主题曲)	丹妮
FucKin' Perfect	Pink
你把我灌醉	关喆
等你回航	龙飘飘
出界	郑秀文
宽容	张信哲
味道	韩磊
出塞曲	蔡琴
东京爱情故事 - 突然发生的爱情 主题曲	小田和正
猜	斯琴高丽,顾峰
像今天这样的眼泪(오늘 같은 눈물이)	许阁
玛利亚的心	歌浴森
12356	正月十五
愈演愈烈	梦洛伊
祝我幸福	杨乃文
恋曲1990	品冠
孙尚香	柳岩
人间情多	李殊
两人行	陈伟霆
给悲伤机会	樊凡
My Oh My(MOM)	少女时代
不存在的存在	邓紫棋
悲怆第三章	贝多芬,钢琴曲
迟到	张行
好男儿	汤潮
Danza Kuduro	Don Omar
迷悟	王铮亮
地铁五号线	歌浴森
美观	孙小宝
路口	张震岳
凌晨1点 (새벽한시)(1AM)	太阳
明月千里寄相思 (国)	徐小凤
圣诞结 (国语)	陈奕迅
All Too Well	Taylor Swift
梦的想	歌浴森
小三前传	冷漠
Echoes Of The Rainbow	李治廷
今年除夕不放假	王绎龙
原点	西单女孩
你懂的	金莎,后弦
另一个天堂	王力宏,张靓颖
Latin Girl	Justin Bieber
难舍难分	谭咏麟
为了谁	董文华
志明与春娇	五月天
哇啦哇啦v	歌浴森
最初的年华	张婧
心花开在草原上	吉娜
我是否也在你心中	高安,囚鸟
不能说的秘密	周杰伦
As Long As You Love Me	Justin Bieber
我要的幸福	孙燕姿
滚滚长江东逝水	杨洪基
飞向别人的床	光光&CK
羞答答的玫瑰唱情歌	格格
我想有个家	羽泉
依然在路上	李健
我总是一个人在练习一个人	林宥嘉
可爱的一朵玫瑰花	云飞
白天不懂夜的黑	张赫宣
遇见了你	央金兰泽
帮助蝌蚪找妈妈（选自A大调小提琴第五协奏曲）	莫扎特
那女孩对我说	黄义达
Black Stallion	George Winston
心太软续集DJ版	赵小兵
哭砂	高胜美
有你真好	范玮琪,杨丞琳
少年	许巍
For the Win	Two Steps From Hell
Never Say Goodbye	Mario & Nasty
我该怎么做	欢子
这个女生有点拽	带泪的鱼
Starships	Nicki Minaj
笑红尘	陈淑桦
Chandelier	Sia
Make You Feel My Love	Adele
死亡小提琴	带泪的鱼
兄弟难当 DJ阿元	杜歌
你的眼角流着我的泪	曹越
因为爱着你	龙梅子
天下最美的草原	呼斯楞
goodbye goodbye	魏晨
爱过那张脸	李代沫
香烟爱上火柴	张政
The Star	EXO
晴空月儿明	西游记
步步(电视剧《步步惊情》主题曲TV Verison)	五月天
牧马人	杨坤
Best Song Ever	One Direction
月光曲 - 世界名曲 钢琴曲	贝多芬
You Must Love Me	Madonna
Every Breath You Take	田园,唐荭菲
云中的angel	张杰
Runaway	Groove Coverage
我的颜色	带泪的鱼
我心似海洋	江美琪
祝酒歌	刀郎
Nothing On You	邓福如
欢乐中国年	孙悦
我很认真	歌浴森
小情歌	杨钰莹
天亮了	S.H.E
不管发生什么别放开我的手	高恺蔚,赵心蕾
魅力无限	孙悦
相忘于江湖	陈楚生
爱与痛的边缘	王菲
满满的爱	满文军
好久不见	张学友
诛仙恋	任贤齐
I Love You	Stewart Mac
当我走过	张恒远
上流玩法	艾怡良
化蝶飞	花儿乐队
Unsterblich	Baschi
海海海	阿悄
我想要你给我一个家	带泪的鱼
冰雪战歌网	我的好兄弟,MC
兄弟的歌	黑龙,徐亮
杨柳	范宗沛
外面的世界	莫文蔚,陈奕迅
말이야 (Piano Ver.)	韩国原声带
外婆的澎湖湾	小蓓蕾组合
当爱已成往事	李宗盛,林忆莲,伦永亮
别哭我最爱的人	水木年华
成吉思汗	腾格尔
出卖我DJ	程响
怀念战友	刘欢
爱到痛处就分手DJ版	何龙雨
国境之南	范逸臣
回梦游仙	心然
白眼狼	杨梓
暧昧	侯湘婷
哈你歌	庾澄庆,徐熙娣
You Are My Sunshine	Carly Simon
哭砂	周华健
掩饰寂寞	阿悄
守候	林海
Who Is It	Michael Jackson
泪海	许茹芸
深蓝色的情书	简红
还是朋友	张雨生
亏欠一生	裘海正
会受伤的人只有一种可能	六哲
轻轻的爱	带泪的鱼
梁祝	吴奇隆
续集	容祖儿
The Garden	George Winston
涟漪	陈绮贞
友谊之光	周润发
任昌丁 - 请开门	NULL
花房姑娘	林志炫
Suddenly	金宝京
如初	李宇春
Listen	林育群
春芽	汪峰
摘下满天星	郑少秋
恭喜发财歌 - 欢乐过新年 大拜年 唱版	新年歌曲
嘟噜沙玛	DJ小可
女人是老虎	李娜
Summer Road	久石让
金玉良缘	陈明_韩磊
南无大悲观世音菩萨	刘小茜
怎么办我爱你	本兮
唯爱	薛凯琪,周子扬
爱我的请举手	王宇
不知去向	梁博
爱不疚	林峯
最近	李圣杰
rollinginthedeep	中国好声音
玫瑰玫瑰我爱你	王若琳
那个女人	白智英
Up	Justin Bieber
最天使	曾轶可
It Will Rain	Bruno Mars
出界	张智成
没有人比你更爱我	陈瑞
套马杆	乌兰图雅
多啦a梦	小蓓蕾组合
I Have Nothing	Whitney Houston
늑대와 미녀 (Wolf)	EXO
南泥湾	梦鸽
小宝贝	巧千金
思念	罗大佑
仰望	杨丞琳
生日快乐	少儿歌曲
挥挥手	汪峰
南方	达达乐队
Doo-Be-Di-Boy	Smile
小情歌	王琪玮
Catch Me	东方神起
沙话	阿悄
无惧此夜	吉克隽逸
记得要忘记	S.H.E
葬花吟	陈力
原来你什么都不要	张惠妹
彩虹的约定	小臭臭
魔力无限	王绎龙
风的颜色	赵咏华,李正帆
Touch love	尹美莱
恼人的秋风	费翔
大男人	黑龙
拿得起放不下	高进
开门见山	张惠妹
婉君	李翊君
Hey Jude	The Beatles
For No Reason	王若琳
偷闲的翅膀	谢馨仪
娉婷扬袖舞风轻	王俊雄
盛夏光年 (Live)	陈冰
相思网	崔子格,徐誉滕
水乡新娘	石梅,冷漠
有多少爱可以重来 (Live)	帕尔哈提
Daylight	Maroon 5
岁月如歌	张智霖
都是酒精惹的祸DJ版	何龙雨
I Love You	2Ne1
不离不弃	艾歌,丁童
留不住你的温柔	李泽坚
Billie Jean	Michael Jackson
我的根在草原	草原歌曲
Intro (Rise)	太阳
天涯歌女	凤飞飞
你的眼睛	熊天平,许茹芸
飞天	含笑
回忆里的疯狂	光良
多情的土地	关牧村
Here I Am	Bryan Adams
往事随风	张杰
寂寞来了怎么办	吴克群
粉红噪音 煲机专用	佚名
新贵妃醉酒	歌浴森
Ascension (Remix)	Dope Arcade,MitiS
半梦半醒之间	谭咏麟
男人不怕失败	黑龙
有你的快乐	王若琳
红尘情歌	昕宇
丹顶鹤的故事	朱哲琴
Hello Dolly	小野丽莎
暴风女神Lorelei	谭咏麟
大地	Beyond
?????	乌兰托娅
Burning In The Skies	Linkin Park
爱情剧终	婧
打靶归来	阎维文
找自己	曾静玟,丁于
回忆	黑龙
无声的雨	孟庭苇
New Again	Brad Paisley,Sara Evans
洗衣歌	索朗旺姆
Air Balloon	Lily Allen
Moon River	王若琳
观音手	斯琴高丽
飘雪	陈慧娴
I Love You	Just
无所不在	吴莫愁
潜意式的残酷	G.E.M.邓紫棋
放你在心里	许美静
狱中望月	迟志强
公路	纵贯线
不是现在 (이젠 아니야)	BEAST
女孩担水	王二妮
关于你的歌	李圣杰
我像雪花天上来	戴玉强
再见(Inst.) 안녕	孝琳(Sistar)
三百六十五里路	文章
彩虹	动力火车
明明知道相思苦	龙梅子
Imagine	John Lennon
向日葵盛开的夏天	飞儿乐团
心经梵唱	佛歌
背包	苏有朋
红河谷	黑鸭子
加速度	瞿颖
jingle bells	小蓓蕾组合
相恋	索朗扎西
나 어떡해 (我怎么办)	T-ara
불치병	Navi,Kebee
小雪	任贤齐
对不起我爱你	梁静茹
Touch My Body	Mariah Carey
新上海滩	叶丽仪
丢手绢	小蓓蕾组合
一千个轮回	易丹
妈咪的怀抱里	胎教音乐
匹夫	黄晓明
考试什么的都去死吧	洛天依
雨一直下	DJ小可
爱情闯进门	By2
像针锥一样	带泪的鱼
爱在发烧	莫龙丹
青衣	马天宇
wrecking ball - dj - davis remix	Frankmusik
吻和泪	周子寒
告诉我	陈绮贞
Girls Girls Girls	GOT7
咚吧啦	萨顶顶
Be what you wanna be	Darin
老婆老婆我爱你	火风
我的爱	孙燕姿
爱人跟人走	陈小云
电话情思	龚玥
盛世大中国	黑龙
我的路线	黑龙
光棍好苦	司文
老街	李荣浩
漂洋过海来看你	杨宗纬
爱上你我傻乎乎	郭玲
All By Myself	Céline Dion
爱你真好难	李玲玉
美丽笨女人	吴莫愁
观音灵感歌	佛教音乐
秘密花园的邂逅	林笛
自己美	萨顶顶
Blowing In The Wind	Bob Dylan
谁的青春没有悲伤	梁晓雪
天竺少女	西游记
就让这首歌	张震岳
因为爱,所以爱	谢霆锋
甩葱歌 (DJ版)	初音未来
向往神鹰	亚东
Hello Kitty	Avril Lavigne
怎么忍心放开手	山野
笑看风云	郑少秋
全国各地	山野
我不恨你	郑源
甘心替代你	郑伊健
大姑娘美大姑娘浪	刘晓
这条街	冷漠
抗战二十年	Beyond
梵音大悲咒	白玛多吉
诺	杨洋,李炜
习惯了寂寞	牛奶咖啡
情人	谢安琪
失恋情歌	安东阳
叶子	阿桑
歌声与微笑	小蓓蕾组合
3, 6, 5	EXO-M
Love Will Keep Us Alive	Eagles
呢喃	任贤齐
吹喇叭 - 完整版 儿童不宜	DJ
a - 思乡佛号	佛教音乐
苏州河（慕容雪 国语版）	薛凯琪
我能CHUA	马飞
原来你什么都不要	孙燕姿
情歌	容中尔甲,旺姆
真的好爱你	黑龙
火柴天堂	熊天平
醉后的心碎	大庆小芳
虚虚实实	张卫健
观音菩萨偈	齐豫
每当我走过老师窗前	小蓓蕾组合
忘记要忘记	李易峰
她	王思远,周华健
不想回家的女人	大哲
六字大明咒	男声
蛋疼	谢华
Hello	GOT7
悲伤的秋千	金海心
Mr.	Kara
妈妈说你都三十了	男人三十组合
只羡鸳鸯不羡仙	梅艳芳
小宇宙爆发	歌浴森
I Hate Myself For Loving You	Joan Jett & the Blackhearts
爱上了是谁的错 DJ舞曲版	糯米
甜蜜蜜	邓丽君
某某 [新编版](live版)	杨坤
风再起时	张国荣
远在咫尺	陈奕迅
Shape Of My Heart	Backstreet Boys
爱恨恢恢	周迅
Story Of My Life	Bon Jovi
请你快乐	歌浴森
冬	好妹妹乐队
站起来	王力宏,成龙,孙燕姿,韩红
小鸡哔哔	洛天依
变成陌生人	王心凌
不药而愈	郭静
败类	网络歌手
飞得更高	陈羽凡,胡维纳
沙龙	陈奕迅
解药	孙紫晴
新不了情	黄小琥
California King Bed	Rihanna
多想把你抱住	高进
小提琴协奏曲	胎教音乐
十二楼	李宗盛
忧伤漫步	黑龙
买间房子好吗	歌浴森
Billy Jean	迈克尔杰克逊
还有一个	金泰妍
这一次我是真的失去了你	李泽坚
爱逝枷锁	带泪的鱼
桃花依旧笑春风	蒋大为
幻音宝盒	秦时明月
亲爱的小孩	苏芮
加油歌	花儿乐队
问心无愧	成龙
让世界充满爱	群星
诱惑的街	梁静茹
执子之手	莫文蔚
Pinnochio(Danger)	f(x)
满满	王铮亮,梁文音
寂寞红	袁姗姗
青苹果乐园	九九,苏梦玫
套马杆	乌兰图雅
早安晨之美	吴木蓝
等你爱我	王琪玮,多亮
U Drive Me Crazy	N Sync
样样红	黄安
七子之歌	谢华
敖包相恋	龙梅子
再活五百年 - 3288	屠洪刚
红豆	陈瑞
肯去承担爱	甄妮
月亮代表谁的心	陶喆
abracadabra	Brown Eyed Girls
再见亦是泪	谭咏麟
Immortal	Thomas Bergersen
剪不断理还乱	龙梅子
羞答答的玫瑰静悄悄的开	孟庭苇
十元人民币	小驴-TOMMY
在那遥远的地方	莫文蔚
Heart	TFBOYS
加油	歌浴森
Living To Love You	Sarah Connor
Dear Mama Don't Cry	Rain
When A Man Loves A Woman	Michael Bolton
三天三夜 (伴奏)	歌浴森
写给父亲	NULL
今天是你的生日	李娜
昨日重现	高胜美
容我不懂	歌浴森
南无阿弥陀佛	原声带
有借有还	陈伟霆
我是真心爱你的人DJ	任军太
幸福拍手歌	小蓓蕾组合
雾里看花	那英
预谋	孙露
So Young	Suede
骑上骏马回草原	东方红艳
拖延症	品冠
纹身	周华健
时间煮雨	小时代
大悲咒 - 梵音 可重复播放	佛经
知道不知道	侃侃
容易受伤的女人 (国语)	王菲
鹊桥汇	花儿乐队
你是我的眼	林宥嘉
为你我受冷风吹	林忆莲
你的温柔 DJ何鹏	子枫
情系大草原DJ版	何龙雨
即客	李代沫
自由の翼	Linked Horizon
今生最爱	王程明
痴心不改	金池
心升明月	李健
伶仃谣	河图
音浪	黄立行
Whenever, Wherever	Shakira
纹身(live版)	周华健
停电	歌浴森
Crazy In Love	Beyonce
MAMA	EXO-K
用多少眼泪才能让你相信	蒋雪儿
伤了我的眼	李泽坚
回家(萨克斯风)	发烧试音碟
想家的时候	阎维文
爱与罪	黄绮珊
感谢	张靓颖
蓝莲花	许巍
感动天感动地	宇桐非
风起来的时光	周子琰
最美的誓言	龙梅子
让过去成为过去	郑源
你走吧	周艳泓
回头太难	张学友
别傻了	周华健,任贤齐
我说今晚月光那么美，你说是的	好妹妹乐队
爱上都敏俊	龚玥菲
让泪化作相思雨	庞龙
半情歌	元若蓝
大骂小日本	洪磊,MC
驿动的心	姜育恒
不能厮守的爱dj版	李泽坚
雨宗林 - 过期的爱情 电视剧 最美的时光 片尾曲	雨宗林
我们都要安	简红
记得	张惠妹
A Loaded Smile	Adam Lambert
我欲成仙	刘欢
岁月轻狂	李治廷
最浪漫的事	男女对唱
老家	侃侃
笑傲江湖	纯音乐
北方的天空下	刀郎
祝酒歌	关牧村
冒险喜马拉雅	歌浴森
I'll Be Back	2PM
冲一杯茶	歌浴森
拨浪鼓	赵薇
Teenage Life	Daz Sampson
小可乐	正月十五
画壁	孙俪,邓超
讨债难dj版	李泽坚
花开在眼前	韩磊
雨下一整晚	周杰伦
茉莉花	蔡琴
오늘 같은 눈물이	许阁
你家门前 (너의 집 앞)	金秀贤
Heart of Courage	Two Steps From Hell
康定情歌	张惠妹
珊瑚颂	韩红
Hot N Cold	Katy Perry
一个男人	金钟国
我从草原来	德德玛
邓紫棋 爱你	NULL
玫瑰玫瑰我爱你	王拓
U Got Me	GOT7
아직도 난 (Still You)	李东海,银赫
南泥湾	崔子格
你不要再对他哭了	NULL
深夜的咖啡	陈瑞
负心的你	林翠萍
Flower Power	少女时代
你知道我对你的好	谢容儿
小妹甜甜甜	杨钰莹
你那么想他不痛吗	带泪的鱼
献世	陈小春
爱你一万年	歌浴森
完成不了的爱	龙梅子
下辈子做你的女人	龙梅子
大吉大利中国年	王麟
忧伤还是快乐	K.Williams
麻木 - 2013最新串烧电音喊麦 www.y2002.com	MC
年轻时代	郑智化
这片草原	降央卓玛
壮志雄心	陆毅
快到我碗里来	王麟
今天你要嫁给我	蔡依林,陶喆
留什么给你	孙楠
小星星 (작은별)	乐童音乐家
偷偷的哭	陈玉建
问情	江淑娜
吐鲁番的葡萄熟了	关牧村
自挂东南枝	Amuro
I'm Yours (Album Version)	Jason Mraz
Someday We'll Be Together	Vonda Shepard
西海情歌	楼兰
Ocean Waves	George Winston
真的好想你	谭炎健
What Can I Do	南拳妈妈
红蜻蜓	By2
别再惊动爱情	张栋梁
最后的问候	BigBang
梦一场	那英
男人酒女人泪	陈瑞
Boom Boom Boom	王绎龙
少年呀	G-Dragon
他说的谎	庄心妍
远飞的大雁	降央卓玛
Nocturne	Secret Garden
潮湿的心	甘萍
Silent night	Belly Gilman
Mad Summer	久石让
不是故意	By2
珍惜	李宇春
有没有一首歌会让你想起我	周传雄
Re:make	One Ok Rock
Good Luck	Beast
我的果汁分你一半	花儿乐队
老实情歌	苏梦玫
奥林匹克鼓号曲	群星
屋顶	陶喆,关诗敏
祝你平安	孙悦
剩女的诱惑	高维那
我的歌声里	歌浴森
一剪梅	张明敏
卡门幻想曲	张乐
忘记你需要多久	阿译
龙	歌浴森
兔子舞	英文歌曲
最爱	周慧敏
孟婆汤	游鸿明
白天不懂夜的黑	黄小琥
新鸳鸯蝴蝶梦	费玉清
吉祥三宝	黑鸭子
Good to be Bad	G.E.M.邓紫棋
合照	汪苏泷
读书郎	小蓓蕾组合
莫斯科郊外的晚上	杨洪基
许愿池的希腊少女	蔡依林
网络情缘	陈星
爱逝枷锁	带泪的鱼
一样的夏天	孙燕姿
我知道你都知道	薛之谦
在一起 (合唱版)	钟欣潼,胡彦斌
歌浴森 - 三天三夜	歌浴森
曾经的约定	By2
天涯歌女	周璇
我是真的爱他	带泪的鱼
你家门前(Inst.) 너의 집 앞	金秀贤
打工行	龙军
太多	王雅洁
情坎	冷漠
野菊花	林志颖
Kiss The Rain	李闰珉
你的爱给了谁	歌浴森
张三的歌	齐秦
放爱情一个假	萧亚轩
水乡新娘	冷漠
天使之城	周笔畅
Du Hast	rammstein
念奴娇	伊能静
幽狐	董贞
歌唱祖国	林妙可
mp3	白狐
离家的时候	刘和刚
she is gone	歌浴森
日光	苏打绿
秋天的海	苏慧伦
兰若词	墨明棋妙
绣红旗	刀郎
三生三世	孟庭苇
爱死了昨天	李慧珍
这，就是爱	张杰
情人博客	谢华
Bailando	Enrique Iglesias
穿过你的黑发的我的手	罗大佑
比我幸福	陈晓东
野百合也有春天	阿桑
小小艺术家	巴赫
We Can't Stop [radio edit - clean]	Miley Cyrus
是我痛 怎么了	带泪的鱼
泡沫	G.E.M.邓紫棋
I'M Outta Love	Anastacia
伤心童话	胡夏
贝多芬的悲伤	萧风
Moonlight Shadow	Groove Coverage
骂醒我	周汤豪
常回家看看	陈红
编号89757	林俊杰
南无阿弥陀佛	古筝佛赞
让我一次爱个够	吴莫愁,庾澄庆
大雨还在下	网络歌手
枕上书	董贞
明天你是否依然爱我	谭咏麟,关淑怡
Fallin For You	Colbie Caillat
春江花月夜	童丽
Lonely	戈锐
小龙人(影视歌曲)	儿童歌曲
依然 - mine mine	歌浴森
不后悔	歌浴森
城里的月光	许美静
梦太晚	董贞
艾薇儿 - Wish You Were Here	艾薇儿
悲伤的秋千	金海心
愤怒的情人	汤潮
专属天使	Tank
爱是你我	李维真,谢丹
光辉岁月	Beyond
穿越人海	张杰
孤独的人是可耻的	张楚
舞曲	冰河世纪,DJ
睡吧睡吧我亲爱的宝贝	NULL
溺爱	本兮
不管有多苦	中国好声音
莉莉安	NULL
小幸福	徐菲琳
Live While We're Young	One Direction
狐狸	纪海星
范儿	大张伟
奇怪,我不懂得爱	本兮,小伟
桃花运	龙梅子
该忘了	郭采洁
牵挂你的我	林志颖
Big Big World	Emilia
一起等地球爆炸吧	棉花糖
妈妈留给我一首歌	郑绪岚
出卖我dj	程响
无名指的等待	谭欣懿
木鱼与金鱼	刘德华
月牙湾	飞儿乐团
好怀念	郑源
姑娘十八一朵花	凤飞飞
简爱	杨千嬅
慈母颂	降央卓玛
出卖	那英
菊花留给你	歌浴森
忐忑	G.E.M.邓紫棋
心疼你的过去	许嵩
红蜻蜓	小虎队
奈何桥边	谢华
boa - masayume chasing	NULL
失语者	简红
拯救 (2013再生抒情版)	成龙
凤凰于飞	孙俪
四海盟约	毛阿敏
不爱也罢	张玮
认了	姚笛
秋意浓	张靓颖
好心分手	王力宏,卢巧音
南无阿弥陀佛圣号	耀一法师
E.T.	Katy Perry
梦回唐朝	唐朝乐队
少女的祈祷	胎教音乐
勇气	梁静茹
多谢了	谢华
上千个黎明	汪峰
洋葱	TF家族
伤痕	曾一鸣
此情可待	纯音乐
北京一夜	张韶涵
老爹老爹	龙梅子
春树秋霜	邓佳坤
海阔天空	林忆莲
Europa	Globus
安娜	冷漠
罪过	谢华
爱着你宠着你	祁隆
摇摇宇宙	简红
铁窗泪	迟志强
流言	周慧敏,林隆璇
该是时候	张柏芝
最卑微的下贱	带泪的鱼
星座	王力宏
忘不了的温柔	安东阳
河山大好	许嵩
想你的365天	李玟,张靓颖,沙宝亮,林志炫
奇迹再现	毛华锋
爱大了受伤了	汤潮
Earth Song	Michael Jackson
爱相随	周华健
MC来了	Mc Hotdog
谢小宇内蒙古黑怕	MC
枉凝眉         For The Perfect	纯音乐
玖月奇迹推荐01	玖月奇迹
生命之杯	Ricky Martin
当你	王心凌
你那么想他不痛吗	带泪的鱼
暗涌	杨丞琳
我只在乎你	邓丽君
另一个天堂	王力宏
共和国之恋	廖昌永
夜空中最亮的星 女声版	秦岚
The Saltwater Room	Owl City
2013社会磕	洪磊,MC
Baby, Don't Cry (人鱼的眼泪)	EXO-M
情深意长	吉克隽逸
古剑吟	古剑奇谭
一见钟情	蓝心湄
\x 0\x .\x-(\x- 	韩旭,阿明
中国火	谢华
我从雪山来	雪山朗玛
非你莫属	林依晨
Let It Rain	Nichkhun
棋子	王菲
快乐老家	陈明
My Turn To Cry	EXO
忘不了	邓丽君
突然好想你	林宥嘉
新娘嫁人了 新郎不是我	印度音乐
缘分	伍佰
西海情歌 - 西藏歌曲 慢摇	降央卓玛
解脱	李玖哲
梧桐灯	许嵩
七子之歌	谢华
真的好想你	电子琴,轻音乐
佛母准提神咒	NULL
Miracle	Cascada
小城故事	二胡独奏
后来	张敬轩
篱笆墙的影子	李娜
小草	北京天使合唱团
我要闹绯闻	郭德纲
开门红	霍尊,艾菲
2013	筷子兄弟
网缘	陈玉建
其实我很在乎你	车静子
坏孩子	许嵩
大吉大利	龙梅子,王麟
填密爱	庄心妍
晚霞中的红蜻蜓	杨钰莹
苦水变美酒	迟志强
Work Bitch	Britney Spears
班得瑞轻音乐	NULL
雪中情	雪山飞狐
客梦	周华健,张大春
When You Say Nothing At All	Alison Krauss
蜡笔小新	电视原声
Y.M.C.A.	The Minions
翅膀	林俊杰
We Wish You A Merry Christmas	Enya
这就是爱	张杰
Price Tag	Jessie J
好心好报	方力申,邓丽欣
遇见	孙燕姿
大笑江湖	高进
我等你	刘若英
擦干你的泪水	刘冲
难忘的一天	丽江小倩
别在伤口洒盐	张惠妹
小星星变奏曲	Studio Musicians
小狼狗	任贤齐
Christmas In My Heart	Sarah Connor
超越梦想	汪正正
铿锵玫瑰	李宗盛
爱我就别伤害我	刘嘉亮
爱你是贪心的	冷漠
念亲恩	陈百强
星星	Vitas
如烟	五月天
伤 (feat. 羽泉)(live版)	项亚蕻
莫呼洛迦	辛晓琪
Love the Way You Lie	Rihanna
艾里甫与赛乃姆	刀郎
天地孤影任我行	陈勋奇
这就是爱吗	容祖儿
贝多芬的悲伤	郑毅
夜来香	邓丽君
麻木 - 2013经典语言不一样的节奏	MC
拥抱你的滋味	dj舞曲
Fly Away	飞儿乐团
下一条微信	夏天Alex
I'Ve Never Been To Me	Charlene
姑娘	胡彦斌
我这个你不爱的人	迪克牛仔
晴朗	许巍
吉祥年	凤凰传奇
咖啡屋	千百惠
高山流水	女子十二乐坊
不知道为什么	六哲
大悲咒 - 古筝 笛子协奏曲	佛教音乐
Try	Asher Book
我愿你知道	郑伊健
眼泪知道	温岚
一天 (A day without you)	JONGHYUN,Chen
\x 	零点乐队
一加一等于我爱你	贺世哲
微笑含着眼泪	歌浴森
迷人的危险 - 紫色迷情	Dance Flow
作曲家	李荣浩
One Man'S Dream	Yanni
妹妹的酒dj版	李泽坚,司徒兰芳
请跟我来	苏芮,范逸臣
听说爱情回来过	彭佳慧
一千零一个愿望	4 In Love
哪里都是你	周杰伦
月光下的凤尾竹	黑鸭子
跟往事干杯	王杰
过云雨	张敬轩
Never Grow Old	The Cranberries
小小粉刷匠	小蓓蕾组合
敖包相会	蒋大为
真真假假	张卫健
怎么做都是我的错	带泪的鱼
未了情	田震
Partita For Double String Orchestra: Iv. Fantasia (Allegro)	邓丽君
最美丽的花	王绎龙
Hey Girl Don'T Bother Me	The Tams
情话  (feat.  孙羽幽)	NULL
Last Of The Wilds	Nightwish
靠近（DJ版）	徐良
眼泪成诗	孙燕姿
一江水	韩红
雨中的红玫瑰	张睿
红豆曲	郑绪岚
思念谁	巫启贤
蒲公英的翅膀	乌兰托娅
Funny Partner	戴燕妮,张柏鸣
祝福	叶倩文
大喜宙	花儿乐队
Don T Know Why	Norah Jones
牵不到你的手	高凌风
藏传大悲咒	琼英卓玛
傻瓜	李代沫
相信未来	MIC男团
Why Would I Ever	paula deanda
多爱你一天	吕方
父亲	迟志强
我是真的爱他	带泪的鱼
空白的缘分(live版)	柳重言
美丽女人	DJ舞曲
甜蜜的伤口	山野
佛乐藏音大悲咒	大悲咒
站在高岗上	张韶涵
让我们回家吧	阿鲁阿卓
爱从分手开始	欧弟
Marry Me	萧敬腾
你不是真正的快乐	五月天
祈祷	蓝色生死恋
回来我的爱	阳一
迷茫的爱	郭玲,冷漠
假情真爱	阿华
客官不可以	小凌_徐良
爱情的枪	陈升,左小祖咒
黎明的曙光	何瑶
不完整的旋律	王力宏
那个傻瓜爱过你	赵传
让每个人都心碎	沙宝亮
我恨我爱你	张惠妹
开心的笑	胎教音乐
喜欢你	Beyond
如果云知道	简红
动天 Heaven-Shaking Event	火影忍者
玛丽亚	金雅中
为了谁	祖海,佟铁鑫
复原	薛凯琪
Never Know	Jack Johnson
分手最痛快	李泽坚
无言的结局	卓依婷
冬季到台北来看雨	杨永聪,周蕙
走过	刘彩星
Best Day Of My Life	American Authors
樱桃红	沈春阳
爱我你就抱抱我	月亮姐姐
放开爱	戚薇
冰河时代女声中文版	DJ小可
有没有那么一首歌 （华谊群星）	中国音超群星
Let’s Dance (偕乐)	Super Junior
Theme From Dying Young	Kenny G
New Soul	Yael Naim
我和草原有个约定	齐峰
来了一群小鸭子	小蓓蕾组合
OCEAN	彭坦,春晓
真爱等一下	陶喆,蔡健雅
穷人也是人	冷漠
期待爱	林俊杰,金莎
剑心	小曲儿
情妇	朱贝贝
空城计-诸葛亮 我正在城楼观山景	于魁智
绝世	张克帆
你知道我在等你吗	张洪量
我一直在路上	谢华
爱是永恒	张学友
国际歌	唐朝乐队
我等到花儿也谢了	张学友
观世音菩萨	陈星
我相信	杨培安
借我一生	水木年华
月满西楼	安雯
回忆唱给你听	小5
只要你的爱	谢华,卢惠美
无泪	袁姗姗,韩栋
Lights	Ellie Goulding
一个人疗伤	带泪的鱼
白衣	河图
爱是怀疑	陈奕迅
萤火虫飞呀飞	郑源
情怨	刘欢
Stay Here Forever	Jewel
去伊犁的路上	刀郎
我的好兄弟	高进,张羽
如果没有你	山野
再别康桥	林宥嘉
我们的天空	黄艺明
Too Many Beautiful Girls (被美女着迷)	Super Junior
赶着马车去北京	MC
Going Home	Sophie Zelmani
古琴禅修	巫娜
下辈子也要找到你	张艾文
离人泪	谢华
天意	刘德华
像男人一样去战斗	小宇,DJ
回想(When I Was…When U Were…)	CHEN,郑秀晶
离场	李佳薇
一起摇吧	谢华
该死的温柔	马天宇
Destiny	少女时代
蓝色的爱	理查德·克莱德曼
流动的城市	林海
再见,原点	白举纲
中华民谣	经典老歌
相思	叶凡
刘海砍樵	李谷一,武力
生来孤独	汪峰
莫西干战役爱情传说	带泪的鱼
卓玛的歌(原创)	降央卓玛
一不小心爱上你	江映蓉,张翰
花神泪	刘诗诗
Change	Sean Kingston
逝去的诺言	陈慧娴
Have Yourself A Merry Little Christmas	Kelly Clarkson
走四方	金志文,曹寅
Goodmorningtoyou早上好	小蓓蕾组合
嫁衣	苏仨
小小少年	小蓓蕾组合
痒	吴莫愁
耶利亚女郎	童安格
爽歪歪	大张伟
变幻的年代	那英
Wonderland	卫兰,24味
Yeah	亚瑟小子
The Voice Within	Christina Aguilera
大悲咒	NULL
在雨中	刘家昌,尤雅
只愿你好	王铮亮
Judas	Lady Gaga
曾经最美	孙露
如果伤害了我你会好过	谢华
飞舞	王冰洋
再见吧 喵小姐	王晓天
白度母心咒	贝玛千贝仁波切
Everything Has Changed	Taylor Swift
粗线条	林育群
有桃花	许嵩
我知道你很难过	蔡依林
梦田	齐豫,潘越云
失恋事小	郁可唯
这感觉怎么样	汪峰
Guts Over Fear	Eminem
葬心	黄莺莺
父老乡亲	彭丽媛
我爱北京天安门	小蓓蕾组合
路灯下的小姑娘	邓洁仪
如果云知道	郁可唯
男人不该让女人流泪	苏永康
伤了我的眼	李泽坚
我们的爱结束了 定样版	带泪的鱼
Let It Be	The Beatles
女人的歌	龙梅子
打樱桃	王二妮
千秋家国梦	田震,小柯
至少还有你	周华健
心墙	林俊杰
泪桥	伍佰
俩俩相忘	辛晓琪
男儿当自强	林子祥
我爱你	S.H.E
Brother Louie	Modern Talking
In The End	Linkin Park
他和她的故事	萧亚轩
我是不是你最疼爱的人	高胜美
再唱山歌给党听	降央卓玛
光荣与梦想	总政歌舞团
咿呦	子曰
娃哈哈	小蓓蕾组合
我爱你,塞北的雪	殷秀梅
徘徊	樊凡
金刚经	佛经
威尼斯的泪	永邦
爱到底	平安,曹芙嘉
茉莉花	女子十二乐坊
Unchained Melody	The Righteous Brothers
有点舍不得	杨幂
神的传说	毛阿敏
谁的眼泪在飞	孟庭苇
爱情的秋天	孙露
稳稳的幸福	小柯
爱很简单	萧敬腾,唐一嘉
敢伤	萧亚轩
Time To Say Goodbye (Con Te Partiro)	Andrea Bocelli,Sarah Brightman
半路	薛凯琪
花祭	齐秦
忏悔文	齐豫
爱是凝望又离开	陶喆
月半小夜曲	庄心妍
After Tonight	G.E.M.邓紫棋
写一首歌	李秋泽
王铮亮的DJ节目——散落在时光里的歌	王铮亮
难以抗拒你容颜	张信哲
上海姑娘	张信哲
Angel Bell	久石让
香格里拉	魏如萱
为你钟情	张国荣
请你放了我	谢华
女驸马 - 谁料皇榜中状元 韩再芬 mtv	黄梅戏
绒花	阿鲁阿卓
吻安	丁娜,布川
恭喜恭喜	中国娃娃
我爱你胜过你爱我	冷漠
风雨人生	韩磊
草原情歌	任军太
我悄悄地蒙上你的眼睛	毛宁,杨钰莹
怎么做都是我的错	带泪的鱼
断了线+回家	林志炫
斗战神	陈奕迅
XOXO (Kisses & Hugs)	EXO-K
六层楼	宋冬野
万晓利 - 女儿情	NULL
小小少年	程琳
天佑携手夜小岩女人们你们听好续集	MC
窗外	李琛
让我爱她	倪安东
Chariots Of Fire	Vangelis
圪梁梁	阿宝
为你等待	白玛多吉
悲伤的眼泪逆流成河	孙露
等你一辈子	NULL
恭喜喜发财财	龙梅子,王麟
小三	云菲菲,冷漠
痛了还想爱	李泽坚
月亮啊月亮	李贞贤
一路两个人	梁静茹
鱼的眼泪只有水知道	谢华
想你的时候	千百惠
你在我梦里	邓丽君
前世今生	电视原声带
蓝色雨	温岚
My Heart Will Go On	Kenny G
滚吧	莫龙丹
不装饰你的梦	蔡国权
爱在天地间	祖海
魂	信
后 (후)	J-Min
Anxiety	曲婉婷
梦一场	张碧晨
一周年	周笔畅
大地	Beyond
江南style	泫雅,PSY
两双	谢安琪,吉克隽逸
爱你	Kimberley
睡莲	我的心在法国苏活
小娃娃	樊凡
我和我的祖国	李双松
即刻出发	吉克隽逸
天不下雨天不刮风天上有太阳	于文华,尹相杰
你的生日	郑智化
人魚伝説	本多俊之
你的温柔 DJ阿圣	子枫
特别的爱给特别的你	伍思凯
像针锥一样	带泪的鱼
阿里山的姑娘	龙飘飘
1973	James Blunt
爱似水仙	金海心
天籁之爱	泽旺多吉,阿鲁阿卓
What Is Love	Janelle Monae
Burn it down	Linkin Park
독한 사랑 (Cold Love)	CNBLUE
爱你一生一世	谢华
A New Day Has Come	Céline Dion
听海	张惠妹
山丹丹开花红艳艳	张绪华
Delicious	Toheart(WooHyun&Key)
说谎的眼泪	任军太
老婆的话就是圣旨	任军太
不可一世	Beyond
无言以对	蔡依林
黑色	带泪的鱼
Rather Be feat. Jess Glynne	Clean Bandit
谢谢侬(国语)	陈奕迅
宝宝睡着了	幼儿歌曲
猫咪宝贝	DJ小可
大山走出的孩子	根呷
我可以抱你吗	张惠妹
望故乡	陈星
凌乱的华丽	单色凌
人质	张惠妹
关于那件事	阿悄,庄心妍
夏天的风	刘瑞琦
纠结	带泪的鱼
相爱的泪水	胡杨林,阿杜
让我们荡起双桨	童声
红歌中国行	丁晓红
山地情歌	高胜美
我到外地去看你	好妹妹乐队
坚强的石头	石头
欠你的幸福	陈诗慧
4.Amore caro, amore bello	Richard Clayderman
大哥你好吗？	甘萍
单恋一枝花	张宇
一帅到底(动画片《熊出没》插曲 )	崔健
脱掉	杜德伟
我真的受伤了	田馥甄
I Say A Little Prayer	Aretha Franklin
花房姑娘	魏语诺
November Rain	Guns N' Roses
天空	王菲
爱是... (ii)	The Daydream
爱的季节	谢华
无聊的狠	关喆,郭涛,高虎
当你离开我	M4M
内线	许嵩
Video Killed The Radio Star	The Buggles
一个人的街	欢子
痛在无底洞	NULL
Sexy, Free & Single	Super Junior
第三者的第三者	弦子
山歌好比春江水	龙飘飘
泡沫(现场版)	G.E.M. 邓紫棋
七滴眼泪	六哲
史卡保罗市集Scarborough Fair	Sarah Brightman
恰恰恰 - chilly cha	拉丁舞曲
勇	杨千嬅
手心里的温柔	云朵
姑娘想嫁人	袁哲
自由	张震岳
鸭子	苏慧伦
发疯	李贞贤
那个女人	谢华
纠结	带泪的鱼
你懂得 (Live)	杨钰莹,小沈阳
An Angel	Declan Galbraith
游乐场	谢霆锋
留在我身边（そばにいるね）	青山黛玛
故人叹	吴琼
Brave	Jennifer Lopez
爱得忘了	谢华
四叶草	李易峰
If You Want Me	Marketa Irglova,Glen Hansard
사랑이라는 이름으로 (English ver.)	KEN (VIXX)
只要你的爱	谢华,卢惠美
心禁锢	带泪的鱼
你快乐未必我快乐	田馥甄
我是一只大苹果	小蓓蕾组合
真永远	刘德华
差半步	陈展鹏
花田错	王力宏
燃烧	孙楠
爱是你我	云朵,刀郎,王翰仪
相思赋予谁	好妹妹乐队
兄弟抱一下	NULL
美丽的草原我的家	德德玛
一直很安静	纯音乐
My All	Mariah Carey
龙卷风	施艾敏
走不近的爱	带泪的鱼
Canon and Gigue in D major for 3 violins and basso continuo	Various Artists
Night Prayer	Iridio
青蛙大嘴巴	小蓓蕾组合
大长今 韩文版主题曲	原声大碟
纯情 - dj 韩国 新抓钱舞	高耀太
Love Warrior 战	尚雯婕
嗨曲 - dj dj - kk 劲爆舞曲现场 狂嗨曲动感	DJ
我爱桃花我爱家	蒋大为
魅妆	简红
大风歌	乌兰图雅
微信爱	陈玉建,陈美惠
崇拜	梁静茹
全世界丢弃了我 你也不离开我	带泪的鱼
中国人民解放军进行曲	军歌
你是我的风景	何洁
给抱着盒子的姑娘	NULL
Love	田馥甄
恋するフォーチュンクッキー	AKB48
以前，以后	A-Lin
Hands Up 举手狂欢	2PM
환절기 (Mid-season)	Super Junior
预谋邂逅	阿肆
海阔天空	陶喆
情深意长	阿鲁阿卓
宝贝宝贝我爱你DJ版	陈兴瑜
火烧的寂寞	何洁
三字经	经典老歌
御龙镜中潜	汪苏泷
小牧童	儿歌
敢问路在何方	刀郎
不会改变	谢天笑
香格里拉	容中尔甲
我依然爱你	许茹芸
永远在身边	大嘴巴
阿凡达与屌丝男	许鹤缤
觉悟	袁姗姗
输了你赢了世界又如何	林志炫
苍天般的阿拉善	德德玛
只能抱着你	梁静茹,光良
繁花	凤凰传奇
张赫宣的DJ节目——经典男人歌	张赫宣
分手那天	徐靖博
寂寞星球的玫瑰	G.E.M.邓紫棋
Dancing In The Rain	水木年华
玻璃杯	曹卉娟
闪亮的日子	孟庭苇
从头再来	崔健
随心摇摆	安与骑兵
最后一次为你流泪	伤感歌曲,最新流行歌曲
遥望	Beyond
我的心里只有你没有他	黄小琥
I Still Believe	Mariah Carey
马背上的柔情	草原歌曲
路灯下的小姑娘	张蔷
月亮与海	NULL
爱需要全心全意	郑源
让梦冬眠	何龙雨,沈嫔嫔
约定	王菲
ANGEL	EXO-M
我是真心爱你的人	NULL
黄河长江	张雨生,杨培安
我真的害怕了寂寞	龙梅子
我上幼儿园	儿童歌曲
True Love	蔡健雅
谁不说俺家乡好	彭丽媛
Tomorrow	Avril Lavigne
烟雨凄迷	陈百强
忘记你太难	阿里郎
摇一摇	黑龙
一念之间	戴佩妮
真爱一世情	李羿慧
极品慢摇 - dj	Alex
傻笑	周杰伦,袁咏琳
手语	孟庭苇
几秒钟	赵小兵
弥烟	谢华
宽容	张信哲
亲爱的小孩	辛晓琪
午夜怨曲	Beyond
接受	梁静茹
上帝是女孩 - 钢琴演奏舒缓版	钢琴曲
相爱容易相思苦	龙梅子
七友	梁汉文
爱的漩涡	NULL
菩萨蛮	刘欢
忘记你的伤悲	李泽坚
唐宋元明清	后弦
小星星 The Star	尚雯婕,华晨宇
妈妈的吻	小蓓蕾组合
gwiyomi song	Hari
女人天下	刘庭羽
站台	杨坤
我的爱	李宗泫
爱人跟人走 - 闽南语情歌大对唱 台	闽南语歌曲
金刚经	王菲
I Swear	The Minions
沂蒙颂	童丽
为梦想，时刻准备着	TFBOYS
都是你	光良
守望白云	央金兰泽
its my life	Linkin Park
爱情宣言	齐秦
爱不爱我	周晓鸥
赶生灵	云飞
完美孤独	莫文蔚
塞北的雪	彭丽媛
森林鸟儿	雷蒙拉普
想起老妈妈	于文华
长安长安	郑钧
炉心融解	初音未来
Moon River	小野丽莎
约定	王菲
该死的懦弱	胜屿
低碳贝贝	林妙可,柳博,香奈儿,群星
We Are One	Westlife
太早	刘允乐
多情的土地	廖昌永
柏拉图式的爱情	陈绮贞
苹果	安与骑兵
Dreams	The Cranberries
友情岁月	陈小春
안녕（Inst.）	孝琳(Sistar)
这边那边	伍思凯
Cappuccino	萧亚轩
分手的理由	安东阳
漫漫人生路	钟镇涛
五星红旗	孙楠
老鼠爱大米	香香
山楂树之恋	徐千雅
万水千山总是情	DJ小可
Let Me Go（DJ版）	苍井空
Dearest	滨崎步
分手在那个秋天	浩瀚
HISTORY	EXO-K
牧羊人	云朵
Baby	EXO-M
感恩	钟丽燕
欢迎进行曲	中国人民解放军军乐团
会长大的幸福	Tank
告别娑婆	陈奕迅
茉莉花开	李玲玉
思凡	林宥嘉
好汉歌	刘欢
对待坏女孩	孙子涵
Dracula	f(x)
斯琴高丽的伤心	斯琴高丽
落墨	李玉刚
中国移动	黑龙,冷漠
放手	何龙雨,傅潇莹
管他什么音乐	范晓萱
白噪音	NULL
走过咖啡屋	王雅洁
一场游戏一场梦	王杰
和天亮说晚安	谢华
beautiful lies	b-complex
御龙三国志	林俊杰
已是两条路上的人	赵雷
我和春天有个约会	邝美云
对的人 错的时候	金池
皇帝的烦恼	赵小兵,冷漠
All About U	G.E.M.邓紫棋
向阳花	谢天笑
Never Say Never	The Fray
dj	金达莱花
死了的心还会爱上谁	徐一鸣
阿弥陀佛心咒 - 地藏经唱诵版	佛教音乐
爱情诺曼底	黄征
卡门	张惠妹
哈依勒	谢华
蝙蝠	邓紫衣
我最亲爱的	苏打绿
北京欢迎你	群星
奈何	邓丽君
妹妹的酒	李泽坚,司徒兰芳
爱转角	罗志祥
天天都想见到你	龙军
单身歌	龙梅子
仙剑赋	董贞
Harder To Breathe	Maroon 5
Time To Say Goodbye (Con Te Partiro)	Sarah Brightman,Andrea Bocelli
下雨的时候会想你	阿杜
Rolling In The Deep	Adele
A Day Without Rain	Enya
霍元甲 - 周杰伦	NULL
飞鸟与射手	NULL
天龙八部	信乐团,赖水清
Rainbow	滨崎步
至少还有你	林忆莲
这个女生有点拽	带泪的鱼
无地自容	孙楠
飞蛾	许嵩
九鼎天下	董贞
lubov	Rosstallanma
为你而来	李健
轨迹	周杰伦
痴心换情深	龙梅子
蛋疼 - mix team djec mix - 2013	谢华
农民	黄家驹
我就要和你在一起	赵英俊,夏筠妍
Pastorale	Secret Garden
大头皮鞋	韩晓
旋律	刘蔓
우리 사이 (我们之间)	MBLAQ
我只在乎你	刘惜君
我知道你离我不远	陈楚生
我的爱情不见了	龙梅子
鹅鹅鹅	小蓓蕾组合
我真的受伤了	王菀之
歌未央	杨宗纬
Who Says	Selena Gomez
官封弼马温	童声合唱
街道的寂寞	石进
独上西楼	邓丽君
兄弟难当 DJ何鹏	杜歌
不要不要	卓文萱
分手的距离	李魏西
london bridge	小蓓蕾组合
白龙马	樊竹青
七剑战歌	七剑
天生一半	郑秀文
卷珠帘 (Live)	霍尊
一生一世爱一回	闫旭
以父之名	周杰伦
This Is The New Shit	Marilyn Manson
自从有了你	赵薇
思念你却牵不到你的手	黑龙
老公你很累	天籁回音
国家	刘媛媛,成龙
最好的我	龚芝怡
爱情惹的祸	姜玉阳
真的用心良苦	郑源
他不爱我	迪克牛仔
康美之恋	谭晶
只要你的爱	谢华
하루 (A Day Without You)	Chen,JONGHYUN
Twinkle	少女时代-太蒂徐
胭脂	刘涛
你好吗	宋祖英
姑娘我爱你 DJ版	索朗扎西
天仙子	谢雨欣
天边的眷恋	金莎
一辈子的赌注	祁隆
I Believe I Can Fly	邓鼓
金瓶似的小山	降央卓玛
回娘家	朱明瑛
太傻	巫启贤
存在	林海
万物high (feat. 常石磊)(live版)	萨顶顶
美妙的西藏	关牧村
女王诱惑	慕容晓晓
天天晴朗	苏打绿
In The Morning Light	Yanni
舞魂再现	罗志祥
家的味道	庞龙
狼	齐秦,韩红
轻熟女 27	MC Hotdog,关彦淳
Loyal (East Coast Version)	Chris Brown,Lil Wayne,French Montana
别亦难	西游记
偏偏喜欢你	陈百强
Pretty	卫兰
春暖花开	周艳泓
As Time Goes By（Time Goes By）	张根硕
人说山西好风光	郭兰英
棒棒棒	MC
想哭了	李泽坚
Mercy	吉克隽逸
和从前一样	黄勇
依然是你	胡彦斌
利柏拉契	潘玮柏
新鸳鸯蝴蝶梦	费玉清
梦的海洋	瑜伽音乐
我要的感觉	黑龙
小小贝壳	小蓓蕾组合
夫妻双双把家还	张也,阎维文
Walking Away	ChianoSky
华山论剑	射雕英雄传
平沙落雁	管平湖
人生何处不相逢	段银莹
Baby	平安
A Sky Full of Stars	Coldplay
Mad World	Susan Boyle
明明说好不哭	何曼婷
你那么想他不痛吗(rap版)	带泪的鱼
天空之城	李志
亲密的爱人	梅艳芳
活着	萧敬腾
Shining Friends	冯曦妤
Shall We Talk	陈奕迅
美人	李玉刚
Tik Tok	Ke$ha
春江花月夜	中央民族乐团
妈妈我爱你	NULL
性感不是骚	DJ
枕着你的名字入睡	龚玥
假象	带泪的鱼
多情的人不该相遇	NULL
Parachute	Cheryl Cole
三步踩 - 天高云蓝 2008-7	草原歌曲
想家的人	简红
风归云	简红
当我靠近你	梁博
亲亲老婆	任军太
亲亲老婆	任军太
纪念	蔡健雅
Hello	Kelly Clarkson
猜不透	丁当
爱你痛到不知痛	张学友
蒲公英的约定	周杰伦
芒果香	谢军
bad apple	初音未来
等一分钟	DJ小可
欢乐的跳吧	佚名
因为爱情（法语版）	弗雷德乐队
有点甜	孙羽幽
我爱木兰	带泪的鱼
我们是兄弟	朱明
小人	赵小兵,冷漠
卖报歌	儿童歌曲
真心换真情	张可儿
\x-'\x/)\x-.\x *\x,*\x-.\x-.\x//	安东阳,樊桐舟
天冷就回来	龙梅子
Fade To Black	Metallica
人生就是一场梦	艾歌
Kolibre（蜂鸟）	Maksim
舞出我人生	平安,金池
运命のルーレット廻して	名侦探柯南
Iron Girl	HA:TFELT,惠林 (Wonder Girls)
吻别	王宇,吴木蓝
人鬼情未了	英文歌曲
不是每个恋曲都有美好回忆	林志颖
千纸鹤	方大同
爱你真的很累	任军太
会有那一天	任军太
我听过你的歌	王焱,何影
年轻无极限	孙燕姿
花葬	同恩
兰花草	叶倩文
孤独不苦	张卫健
从爱发落	罗志祥
一分钱	小蓓蕾组合
初恋未满	张含韵&曹轩宾
我是真心爱你的人 - 吉特巴 z4 - 6.54 升	任军太
滚滚红尘	袁娅维
你懂得	小沈阳,沈春阳
光芒 全新缩混版	凤凰传奇
你想要的是什么	龙梅子
Rolling In The Deep	吉克隽逸
枉凝眉	陈力
阿狼	任军太
夫妻那些事	大庆小芳
Dj舞曲凤舞九天	群星
日子	小柯
我爱我中华	龙梅子
Sail	AWOLNATION
三千世界鸦杀尽	洛天依
恋恋大草原	正月十五
Rap God	Eminem
阿弥陀佛在心间	龚玥
东方之珠	罗大佑
小夜曲 - 世界名曲 古典钢琴	古典音乐
落桃花	任军太
存在	雷婷
是我不对	高安
又见炊烟	龙梅子
再见我的爱人	邓丽君
你知道我在等你们分手吗	卫兰
说谎的眼泪	任军太
思密达	王麟
单人旅途	许嵩
안녕	
问	龙梅子
爱我别走	周杰伦
高原女人	央金兰泽
三生三世	王蓉,萧正楠
爱我久久	阿牛
透过开满鲜花的月亮	林依轮
盗墓笔记·无邪	音频怪物
如果来生还能遇见你	郝云
广陵散	中央民族乐团
Waka Waka (Esto Es Africa)	Shakira
男儿当自强	林子祥
易水两岸	秦时明月
Fake Your Death	My Chemical Romance
那个男人的谎言	Tae In
星球大战主题曲	群星
草原情歌	任军太
借点情借点爱	曹越
逆流的泪	温岚
他不准我哭	邓丽欣
So What	P!nk
La Vie En Rose 玫瑰人生	小野丽莎
口是心非	带泪的鱼
当我想你的时候(live版)	汪峰
钢铁是眼泪炼成的	任维
看透	莫文蔚
爱一直存在	梁文音
白度母心咒	NULL
憨过头	龙梅子
渔舟唱晚	古筝佛赞
最卑微的下贱	带泪的鱼
最美的相遇	杨钰莹
笛子	新白娘子传奇
Angel	陶喆
花儿爱上忘情草	王强
水深火热	任军太
没有我你好好过	任军太
皇帝的烦恼	赵小兵,冷漠
剑起苍澜 	NULL
恋曲1990	高胜美
侬本多情	张国荣
锄禾日当午	小蓓蕾组合
问	简红
Telephone	Lady Gaga,Beyonce
Vincent	王若琳
春天的欲望	谢华
有没有一种思念永不疲惫	群星
我想有个家	潘美辰
绿野仙踪	陈悦
共同渡过	张国荣
Good Bye	张根硕
这么近那么远	张靓颖
爱信仰	龙梅子
给你看 (보여줄게)	Ailee
爱逝枷锁	NULL
摇太阳	方芳
黑色	带泪的鱼
海阔天空	黄贯中
想你想到心里头	杨浩龙
容颜	任军太
一声叹息	郝云
故事	许巍
就算没有明天	黄晓明,孙俪
骆驼之歌 - 王小黑	MC
Leave Out All The Rest (Single Version)	Linkin Park
考试什么的都去死吧	徐良_雨洁
Believe Me	Fort Minor
我爱的人	陈小春
净土	孙楠
两只恋人	曹格
花心	周华健
错过了缘分错过了你	司徒兰芳
陌上归人	区瑞强
胜女的时代(TV Verison)	江语晨
爱拼才会赢	十二大美女
That S Why (You Go Away)	Michael Learns To Rock
烛光里的妈妈	张赫宣
再爱一回	任军太
宇宙之大	许嵩
Dear Friend	顺子
漂亮的姑娘你别怕 - 快四 dj 混音版	李贵府
时间都去哪儿了	张碧晨
爱的翅膀受了伤	蒋雪儿
相信我没有错 (新版)	贺世哲
卑微的承诺	乔洋
Baby, Don't Cry (인어의 눈물)	EXO-K
阿猫阿狗	陈奕迅
戒情人	郑中基
花仙子	小蓓蕾组合
让世界为你转身	张玮
野孩子	杨千嬅
雄心无泪	龙梅子
舞女	龙飘飘
Kiss	2Ne1
月圆花好	费玉清
我爱你塞北的雪	曹芙嘉
王妃	萧敬腾,肖懿航
我们的梦	汪峰
Twinkle Twinkle Little Star	Twins
等	陈百强
Ringa Linga	太阳
大耳光	NULL
Complicated	Avril Lavigne
爱你一万年	伍佰
玫瑰花与傻瓜 (r&b版)	任军太
摇摇宇宙	简红
Lady Marmalade	Christina Aguilera,Lil' Kim,Mya,Pink
花心男	慕容晓晓
温柔与霸道 - 专业下载 专业的设备	杭娇
新回心转意	黑龙
雕花笼	董贞
天若有情	袁凤锳
那个男人	白智英
老公你辛苦了	网络歌曲
米店	张玮玮,郭龙
长相爱贵相知	大庆小芳
我真的受伤了	简红,孙伯纶
Butterfly (蝴蝶)	Henry,SEUL GI (SMROOKIES)
雪域的祝福	央金兰泽
疯狂舞台	任军太
Southampton	James Horner
医生	许嵩
妈妈我爱你	NULL
我相信	中国好声音学员
California Dreaming	The Mamas & The Papas
一个人的战役	黄征
我还是不懂	A-Lin
祝福你	群星
妈妈我爱你	NULL
最后一次	宇桐非
你最近还好吗	S.H.E
牡丹亭外	陈升
城里的月光	齐秦
fiction	Beast
征服	林志炫
电台情歌	莫文蔚
失去你才知道	NULL
百合花	龙梅子
Vois Sur Ton Chemin	原声大碟
Beautiful World	宇多田光
来自星星的你 - Lyn - My Destiny OST]	NULL
Time after time ～花舞う街で～	仓木麻衣
彩云追月	爱戴
小老鼠	小蓓蕾组合
\x $\x.!?\x *\x,*?\x $H	乌兰托娅
来自星星的你 (별에서 온 그대)	Younha
自由飞翔	我的心在法国苏活
漂亮的姑娘你别怕 - dj 蓝 加快版 博白	李贵府
吻你	哈琳,锡林宝力日
全世界最伤心的人	老猫
大雨还在下	龙梅子
哥哥妹妹要安慰	何龙雨,孙语
我是真心爱你的人 - 2011伴奏	任军太
爱和承诺	陈慧娴,张学友
爱情重点	石梅
Football Kids	Club 8
傻女	李克勤
我和小伙伴都惊呆了	赵小兵
光着我的脚丫子	戴佩妮
亲亲老婆 (dj版)	任军太
Get Over You	G.E.M.邓紫棋
非走不可	谢霆锋
彩虹 (무지개)(Rainbow)	f(x)
用心良苦	齐秦
只是你 (다만 그대를)	朴始焕
说谎的眼泪	任军太
可惜我是水瓶座	杨千嬅
前度	朱雅
今宵多珍重	龙梅子
年度之歌	谢安琪
血染的风采	张也
莫失莫忘	心然
追寻	孙楠
EXEC_COSMOFLIPS_.	吉田亚纪子
就算世界无童话	卫兰
Single Ladies (Put A Ring On It)	Beyonce
孤星泪	伍佰
你把我灌醉	动力火车
你为什么抛弃我	NULL
Grenade	Bruno Mars
回心转意 - 2009 - dj2009 dj 版	黑龙
Only Love	Groove Coverage
我就不爱唱情歌	大张伟
如果伤害了我你会好过	谢华
留不住斜阳	韩宝仪
明月千里寄相思	韩宝仪
其实我们都没错	郑源
风中有朵雨做的云	孟庭苇
当爱离别时成品	龙梅子
Time In A Bottle	jim croce
再见爱人	李泽坚
别把我的心带走	孙露
老婆的话就是圣旨 (dj版)	任军太
依然在一起	马天宇
小龙人	小龙人
外婆的彭湖湾	张明敏
勿忘心安	张杰
讨债难	李泽坚
情人知己	叶倩文
懂你	萨克斯
βios	澤野弘之
把悲伤留给自己	赵鹏
下一站是幸福	徐千雅
爱情故事	理查德·克莱德曼
有没有	By2
但愿人长久	龚琳娜
逆光飞翔	范逸臣
His Mistakes	Usher
制造浪漫	简红,妮妮,张圣启
十一年	谭艳
我心蹦蹦跳	NULL
想家的人	简红
夜来香	小野丽莎
Brown Eyes	Lady Gaga
坏人恋人	简红
Safe and Sound	Capital Cities
对歌	林海
傻子	杨添茸
我就是爱你	萧敬腾
菊花台	周杰伦
Amaranth	Nightwish
光之翼	张目
Get Up Offa That Thing	James Brown
三吋日光	梁静茹
等不到的爱	文章(演员)
我心永恒	童丽
爱永远	龙梅子
月儿弯	龙梅子
1 - 村长的新娘	李泽坚
我是真心爱你的人 - 收藏 如此珍爱	任军太
这一次我是真的失去了你	李泽坚
终点	关心妍
村长的新娘 (dj版)	李泽坚
henrik wikstrom - beautiful day	NULL
故乡	许巍
做你怀里的那只猫	贺世哲
PSY - 江南Style   高清官方版	PSY
因为爱你	陶钰玉
anyclub	李孝利
为了我为了你	任军太
赛马	女子十二乐坊
爱不会绝迹	林俊杰
有一天我们都会老	钟汉良
流水年华	胡海泉,曾静玟
Baby Song	陈奕迅
Lollipop	BigBang,2NE1
仙女湖	徐千雅
浏阳河2008	陶喆
Knock Knock	Lenka
Larger Than Life	Michael Lington
最右 - 老猫 网络红歌	龙梅子
遗忘	谢华
我这样的男人	郑智化
一起摇吧	谢华
说谎的眼泪 (dj版)	任军太
皇帝的烦恼	赵小兵,冷漠
牵挂	孙楠,姚贝娜
每天爱你多一些	张学友
末日不孤单	李代沫
R.O.D.	G-Dragon,Lydia Paek
one,tow,three,four,five	小蓓蕾组合
父亲是山	任军太
春天的欲望	谢华
我们爱过就好	龙梅子,薛之谦
往生咒	印能法师
隐形的第三者	简红
butterfly	Christina Perri
我想买套房	NULL
明明白白我的心	成龙,陈淑桦
Somewhere Only We Know	Lily Allen
一个人	任贤齐
白衣飘飘的年代	叶蓓
Wonderful Tonight	方大同
让一切随风	陈慧娴
无悔无憾	王杰
红	张国荣
月桂女神	S.H.E
洋葱	五月天
心灵睡过的地方	韩磊
人鬼情未了	钢琴曲
东北东北	张冬玲
再见爱人dj版	李泽坚
我配不上你	夏天Alex
相亲不相爱	李泽坚
不必在乎我是谁	林忆莲
坚强的理由	莫文蔚,伍佰
你不要再对他哭了(rap版)	带泪的鱼
一段情一段伤	龙梅子
Dream Catcher	韩国原声带
Yellow	Coldplay
心痛要到什么时候	龙梅子
且行且珍惜	张信哲
星空	许巍
手牵手	米儿丝
青藏高原	云飞
绿度母心咒	ani choying drolma
你的选择	易欣
月牙泉	田震
再接再励	龙梅子
Baby	丁丁,黄一
你不要再对他哭了(旋律版)	带泪的鱼
大头儿子小头爸爸主题曲	佚名
谎言之躯	汪峰
Love Is Colorblind (Bonus Track) (Feat. Tq)	Sarah Connor
爱多一次痛多一次	谭咏麟
祥音	空雨
江南style	pls鸟叔
蓝色的蒙古高原	德德玛
一样爱着你	By2
爱好辛苦	龙梅子,韩松圃
Croatian Rhapsody(克罗地亚狂想曲)	Maksim
春泥	张芸京
杜十娘	李娜
落叶	刘恺威,白冰
花恋蝶	南拳妈妈
回来	罗琦
四月	林海
Eh, Eh (Nothing Else I Can Say)	Lady Gaga
情人桥	龙飘飘
再爱一回	任军太
High歌	黄龄
回心转意 - dj 阿圣 remix	黑龙
Main Title	Ramin Djawadi
老婆的话就是圣旨	任军太
出卖	简红
光明	谭艳
天马座的幻想 - f ver	圣斗士星矢
你把我灌醉	G.E.
Somebody That I Used to Know	Kimbra,Gotye
花旦	周华健
眼泪	简红
父亲是山	任军太
为你我受冷风吹	杨宗纬
回心转意 - dj 加快 小于 m dj.sy.2 角	黑龙
情系半生	张学友
风云	黄耀明
不是我不小心	张镐哲
快乐老家	陈明
当我开始偷偷的想你	张惠妹
大风大浪大步走	李泽坚
Diana	One Direction
慈爱	龙梅子
静静的	庾澄庆
今夜无眠	龚玥
天地在我心	刘欢
哭诸葛	刘欢
像雾像雨又像风	梁雁翎
Prisoner Of Love	宇多田光
老友记	金志文,关喆
我要飞	飞儿乐团
Pretty Baby	Honey B & T-Bones
小李飞刀	许冠杰
画心	孙露
情歌	陈珊妮
Somebody Loves Somebody	Céline Dion
边界	汪峰
回心转意 - 2009 - dj 版 作曲 隆隆 作	黑龙
披着羊皮的狼	郑源
冰封的记忆	陈魁
老有所依 (feat. 马上又)(电视剧《老有所依》片尾曲TV Verison)	那英
我是一条小青龙	小蓓蕾组合
黄土高坡	杭天琪
Butter-Fly	和田光司
凌晨三点钟	张智成
临别一眼	周传雄
写给方大同	刘心
够钟	周柏豪
三德歌	谭晶
我要我们在一起	陈羽凡,肖懿航
三只熊(韩国儿歌)	未知
非你不爱	弦子
让我爱	阿桑
父亲是山 (dj版)	任军太
Love Struck Me Down	曲婉婷
本草纲目	周杰伦
她在睡梦中	朴树
英雄	汪峰
火烧的寂寞	曾一鸣
祖国你好	张也
把悲伤留给自己	蔡琴
吻别 英文	佚名
开场曲 - cut - qq 空间 非主流歌曲	劲舞团
家乡的姑娘	索朗扎西
振华英雄	黑龙
边走边爱	谢霆锋
如果还有明天	信乐团,柯有伦
玫瑰花与傻瓜	NULL
只欠秋天	马天宇
旗开得胜	张学友,张靓颖,K Naan
爱上鲨鱼的人鱼	朴熙京
世间始终你好	罗文,甄妮
不能厮守的爱	李泽坚
情债	陈明真
回心转意 - 伴奏	黑龙
Star	15＆
超有感	黄鸿升
梦的翅膀受了伤 (新版)	蒋雪儿
美丽心情	本多Ruru
一见钟情	李晟
爱的箴言	霍尊,仲小蝉
藏家姑娘	降央卓玛
如果爱上你是一个错	丁亮
Beautiful In White	Shane Filan
Tell Me Why	Lafee
陀飞轮	陈奕迅
老情歌	吕方
我的快乐	锦绣二重唱
Roc	Nadiya
我最宅	苍井空,果宝酱JAM
我的右边你的左肩	贺世哲
准提咒	陆墨妮
兰花草	刘文正
谁都不要说分手 - 快三 开心	龙梅子,冷漠
When You Cry	凤凰传奇
为什么你要伤害一个爱你的人	欢子
其实我的心没走	周艳泓,黑龙
北京一夜	信
一天一天 (Orchestra Ver.)	BIGBANG
滚滚长江东逝水	朱之文
敬你一碗青稞酒	容中尔甲
Call You Tonight	Whitney Houston
家园	刘欢,宋祖英
原来我和你	龙梅子
宽恕	王菲
心脏被挖空的痛	带泪的鱼
味道	辛晓琪
Way Back Into Love	Hugh Grant
不必多说	任军太
藏传大悲咒	马常胜
一个人的疗伤	带泪的鱼
Seven Years	Norah Jones
相见太晚	苏有朋
泪满天  (DJ阿远    Remix)	龙梅子
和兰花在一起	雅尼
琉璃	孟庭苇
妈妈我爱你	NULL
Love Game	Lady Gaga
secret base ～君がくれたもの～	Zone
美しき残酷な世界	日笠阳子
得民心者得天下	刘欢
好男人	张赫宣
不具名的悲伤	罗志祥
有钱没钱回家过年	龙梅子
草原上的格桑拉	草原歌曲
女大要出嫁	龙梅子
牵挂	伍佰
龙卷风	周杰伦
学习雷锋好榜样	小臭臭
分分合合	庄心妍,萧全
Bring Me To Life	Evanescence
I Believe I Can Fly	R. Kelly
我的爱不能给的这样草率	龙梅子
高山流水	古筝
未给姐姐递出的信	赵雷
老爸老爸	NULL
淡淡的歌	许飞
心痛2011	小山
The First Snowflakes	班得瑞
爱情36计	蔡依林
七色光	小蓓蕾组合
轻轻听	基督教歌曲
月亮	陈慧娴
Boyfriend	Justin Bieber
做你的雪莲	艾歌,何龙雨
南屏晚钟(国)	徐小凤
致青春	龚琳娜
Shots	LMFAO
如果没有你	林天爱
风雨同路	徐小凤
你是不是我最疼爱的人	蓝岚
飞鸟与鱼	齐豫
卧龙吟	刘欢
草原情歌 (dj版)	任军太
When I'M Gone	Eminem
大桥上	汪峰
而我知道	五月天
老婆饼	汪苏泷
Rap God	Eminem
草帽歌	崔健
So Sick	Ne-Yo
下辈子做你的女人 - dj 王志 rmx	龙梅子
多爱我一点	温岚
梦醒时分	迪克牛仔
三步踩	交谊舞曲
红色石头	李智楠
Refrain	Anan Ryoko
没有人像你	梁静茹
趁早(2005版)	张宇
现场 - 超好听 的 英文经典	dj舞曲
是爱	陶晶莹,方大同
让世界充满爱	群星
宝贝我的宝	阿牛
小丑的梦想	带泪的鱼
I Need You	Westlife
风一样的女子	NULL
你猜猜我有多爱你	龙梅子
归去来	胡兵,希莉娜依
痛	李翊君
冷暖自知	张楚
身在梁山	周华健,张大春
说你爱我	张睿,许艺娜
风中有朵雨做的云 (Live)	杨钰莹,孟庭苇
不要因为寂寞才想我	王闯
Spoonful	吉克隽逸
发如雪	纯音乐
酒干倘卖无	迪克牛仔
数码宝贝主题曲	网络歌手
十字街头	周迅,金城武
橄榄树	理查德·克莱德曼
Set Me Free(放过我)	张力尹
蔓延	许美静
让我一次爱个够	孙露
One Night In 北京	信乐团
妹妹背着洋娃娃	漠凌兮
Sorry Seems To Be The Hardest Word (Feat.Elton John)	Blue,Elton John
Berzerk	Eminem
说唱脸谱	凤凰传奇
失去你才知DJ	任军太
原来的我	范玮琪,曾静玟
玩腻	M3
我们的爱结束了 - 90后非主流	带泪的鱼
情歌对唱	DJ
你的第一	霍建华
中国十大古典名曲之五	古典音乐,十面埋伏
八连杀 肚兜	佚名
I'm A Freak	Enrique Iglesias
发现	路绮欧
不如不见	李行亮
遥望	Beyond
漫步人生路	刘惜君
你微笑时好美	谢霆锋
我心永恒	毛宁
残忍	带泪的鱼
翅膀	林依晨
十五的月亮	蒋大为
Shut Up And Let Me Go	The Ting Tings
活出个样来给自己看	赵本山
人生若只如初见	王韵壹
那么美	杨坤
留不住你的温柔	李泽坚,司徒兰芳
门没锁	品冠
爱我请留言	吴若希
大火	李佳薇
梁祝钢琴曲 - 离歌	理查德克莱德曼
别把自己当成腕儿	李泽坚
无所谓	张赫宣,杨坤
凑热闹	By2
白狐	云菲菲
Brave	Sara Bareilles
The Apl Song	The Black Eyed Peas
草原我的情人	乌兰托娅
잠시 안녕처럼 (Goodbye My Love)	Ailee
Empire	Shakira
天上有没有北大荒	韩磊
灰色空间	罗志祥
你把爱情给了谁 - 并四 心兰制作	龙梅子,王强
玫瑰玫瑰我爱你	凤飞飞
神马都是浮云	山野,吕雯
Insomnia	Craig David
一首简单的歌	王力宏
That xx	G-Dragon
东方红	李姗殷善音
走过咖啡屋	张蔷
痴情的爱	韩宝仪
正月十五闹花灯	正月十五,皆大欢喜
别咬我	许嵩,影子,阿布
一颗心的距离	范玮琪
这支烟灭了以后	张静波
中三傍晚的思念	龙梅子,草原歌曲
倒带	周杰伦
滴答	杨幂
小城故事	蔡琴
戒不掉你的温柔	六哲
爱在天地动摇时	郑家星
天堂草原	降央卓玛
难忘今宵	董文华
时间都哪去了	NULL
Step	Kara
十面埋伏	S.H.E
还是会	韦礼安
蜗牛与黄鹂鸟	卓依婷
冰河时代2(Dj Yufei Remix)	网络歌手
粉红的回忆	李玲玉
谢幕	侃侃
男儿志(少林足球插曲)	刘德华
Rather Be 	Clean Bandit,Jess Glynne
第几个100天	林俊杰
影子爱人	钟洁,袁晓婕
龙卷风	林忆莲
我不懂爱	G.E.M.邓紫棋
草原夜色美	呼斯楞
暖风	周传雄
爱情终点	王绎龙
离别的车站	赵薇
新年到	小蓓蕾组合
海阔天空	汪小敏
Best Song Ever	One Direction
Can't Remember to Forget You	Shakira
너를 너를 너를 (You You You)	Fly To The Sky
这样爱你对不对	陈淑桦
等不到的爱	文章(演员)
爱情美酒	NULL
烧酒话	卓依婷
焚心以火	叶倩文
值得	迪克牛仔
最右	龙梅子
不小心	贺世哲
Spring	久石让
下辈子做你的女人(remix王志)	龙梅子
月光爱人	曾一鸣
空城 - 杨坤 dj失名 remix	Dj失名
传递梦想(让你移动)	黑龙,冷漠
求苍天一件事	贺世哲
你把爱情给了谁(你把爱给了谁)	黑龙
Better Life	飞儿乐团
给所有单身女子	李宗盛
七子之歌	容韵琳
牧羊曲	董文华
财神到	过江龙
老婆对我说	徐一鸣
犯贱（DJ版）	徐良
我不是在笑	Lee Ssang
不要在脸上留下眼泪	罗百吉,宝贝
离别的眼泪	龙梅子
mlk(feat snoop dogg nate dogg)	龙梅子,Warren G
你好吗，天气好吗	邓福如
开心的马骝	刘德华
脑海有浪	温岚
我是你的	倪安东
爱断情伤	带泪的鱼
挪威的森林	伍佰
妹妹你大胆的往前走	戴荃,蘑菇兄弟
On the Floor (Ft. Pitbull)	Jennifer Lopez
Come And Get Your Love	Redbone
对不起我爱你	蔡淳佳
Light Up the Way	飞儿乐团
空城	王菲
妈妈的吻	朱晓琳
风华燃尽-指间砂	少司命
渔家姑娘在海边	宋祖英
爱错人	赵小兵
心中的女神	云飞
心太软	任贤齐
红山果	安与骑兵,李玉刚
あなただけ見つめてる	大黒摩季
感恩的心	陈红
慢摇舞曲	慢摇
无以名状的快乐与悲伤	棉花糖
五哥放羊	阿宝
Memory	Sarah Brightman
无情的雨无情的你	周晓鸥
阿瓦尔古丽	刀郎
Make You Feel My Love	张珈铭
相思曲	张嘉倪,袁珊珊,舒畅
枪恋	本兮
山楂树	黑鸭子
莫扎特：土耳其进行曲：A大调钢琴奏鸣曲第三乐章(Piano Sonata No.11 in A major K331 : III Alla Turca)	Karl Engel
最初的最美	胡杨林
摩的大飚客	庞麦郎
暖城	龙梅子
再见了最爱的人	水木年华
天天想你	韩红
独一无二	郑秀文
等你	大庆小芳
我们总是在寻找	花粥
梅花三弄	卓依婷
你想好怎么对她说	许佳慧
十五的月亮	彭丽媛
深夜地下铁	陶钰玉
退后	周杰伦
哈	黑龙,DJ
Promise	少女时代
等到桃花开	庞龙
秋意浓	沙宝亮
你是太阳我是星星	小臭臭,泰歌
櫻吹雪	周传雄
真的,用了心	成龙
亚特兰提斯	飞儿乐团
自我催眠	罗志祥
十七岁的新娘	龙梅子
爱的好甜	贺世哲
Run To You	Lasse Lindh
走过咖啡屋	千百惠
万事如意	张也
Hush Hush	The Pussycat Dolls
在那不遥远的地方	许嵩
花好月圆夜	杨千嬅,任贤齐
别走	龙梅子
只有两个人的小说	带泪的鱼
雨声	轻音乐
Bing Bing	Crayon Pop
海豚音	杰克逊
秋窗风雨夕	郑绪岚
包袱	胡彦斌
爱的罗曼蒂	带泪的鱼
I Won't Give Up	Jason Mraz
浪子的心情	闽南语歌曲
可遇	杨钰莹
找个人来疼	贺世哲
红星歌	小蓓蕾组合
故乡	许巍
情人	杜德伟
社会摇	NULL
顺流、逆流	徐小凤
亲爱的我爱你	带泪的鱼
Ultraviolence	Lana Del Rey
花心传说	龙梅子
非你莫属	Tank
情网	林翠萍
飞天	含笑
于谦 - 人在江湖 相声专场跨年晚会	郭德纲
女人心事	陶晶莹
红尘叹 (feat. 陈瑞)	冷漠
男人KTV	胡彦斌
祈祷	卓依婷
My Everything (2013 Re-recording)	李敏镐
If Everyone Cared (Album Version)	Nickelback
北京的金山上	韩红
容颜	陈楚生
River Side	久石让
Jasmine Flower 茉莉花	Kenny G
谁料皇榜中状元	严凤英
你把我灌醉	王杰
眼泪会笑	带泪的鱼
最后一页	江语晨
当爱情经过的时候	周艳泓
高山流水	纯音乐
长衣袖	卓文萱
千万次的问	刘欢
Long Live	Taylor Swift
葡萄成熟时	陈奕迅
剑雨浮生	吴青峰,萨顶顶
还是朋友	张雨生
你把我灌醉	刘德华
处处吻	杨千嬅
回家	顺子
风中的额吉	呼斯楞
谢谢我的爱人	山口百惠
我想听你说爱我	龙梅子
LETTING GO	JYJ
该不该	寂悸
相思	谢军
千年之恋	信乐团
海边的星空	理查德·克莱德曼
游牧情歌	格格
Victory（胜利Remix版）	Maksim
女人的选择	沙宝亮
最佳听众	萧亚轩,韩庚
做你怀里的那只猫 - dj 加快 2013	贺世哲
空气	带泪的鱼
岛歌	汤旭
穿越火线 主题曲一(CF,cf)	穿越火线
让我欢喜让我忧	许明明
这样的孤单	汪峰
香巴拉并不遥远	乌兰图雅
够不着的吻	贺世哲
爱恨情歌	冷漠,张冬玲
小棋童	NULL
不痛	周笔畅
请不要在别人的肩上哭泣	赵传,红十字合唱团
那谁	苏永康
听妈妈的话	周杰伦
Neon Lights	Demi Lovato
夜夜夜夜	齐秦
Dreams	Carmen Cuesta
在一起	胡彦斌
泡面的幸福	李泉,蔡妍
I Got You (I Feel Good)	James Brown
只对你有感觉	林俊杰
圣诞旅行	带泪的鱼
Bad Romance	Lady Gaga
野孩子	纯音乐
错怪	杨幂,刘恺威
怎么办	朱杰
高原蓝	龚玥
未来	魏晨
花开花落	李羿慧
一二三四歌	阎维文
思念	NULL
Ok	Jenniffer Kae
相见恨晚（清晰版）	彭佳慧
街角的祝福	戴佩妮
涛声依旧	龚玥
后知后觉	中国好声音
柔板Huldreslatter	莫扎特
相信自己无限极	陈奕迅
不做你幸福的玫瑰	红月
神香	萨顶顶
最长的电影	茜拉
爱到此为止	贺世哲
课桌上的青春	Xun
公路之歌	痛仰
看透爱情看透你	冷漠,宁菲儿
喜洋洋	喜庆锣鼓
童年的回忆	钢琴曲
大舌头	吴克群
二缺一	蔡卓妍
Rockstar	Nickelback
十送红军	杨钰莹
逍遥游	吴佳明
愿牵你的手	刘德华,彭佳慧
红梅赞	龚玥
冰吻	王键
婚誓	杨钰莹
白白的	张韶涵
错过的花季	庄心妍
梯田	周杰伦
我是一个被爱伤过的人	林峰
妄想之夜	阿悄
Travel	李敏镐
My December	Linkin Park
If I Could Fly	Joe Satriani
Destiny	Jaci Velasquez
Hero's Theme	Steven Burke
单身情歌	林志炫
铁塔凌云	许冠杰
我的未来不是梦	胡彦斌
甲乙丙丁	张学友,郑中基,许志安
桑巴 - 桑巴舞曲 sb0216 永远快乐	印度歌曲
It Should Be Easy	Britney Spears
无奈的结局 - 闫旭 正式版	龙梅子
别以为你帅	龙梅子
秋日恋歌	水木年华
夏天的风	元卫觉醒
火柴	筷子兄弟
暗恋过，结局呢	新街口组合
同一首歌 (2013版)	毛阿敏
我的最爱	张韶涵
Knocking On Heaven’S Door	Bob Dylan
仙儿	二手玫瑰
爱是你我	王二妮
爱我中国	龙梅子,格格,高安,祁隆
久别的人	白雪
爱的世界只有你（对唱版）（feat.乐凡）	祁隆
囚鸟(声动亚洲)	简红
靠近一点点	梁心颐
打起手鼓唱起歌	关牧村
Forever Young	GOT7
童年	成方圆
赞歌	胡松华
贵妃醉酒	梅兰芳
无奈的结局 - 闫旭 正式版 极速	龙梅子
佛说万物生	NULL
First Love (feat. EB)(初恋)	T-ara
恶作剧	林依晨
不再留恋	耿云飞
兄弟无数	景岗山
老爸	常石磊
这片海	顾莉雅
我知道我不懂爱	六哲
情海无兵刀	龙梅子
失窃之物	戚薇
榣山遗韵	古剑奇谭
纯真年代	爱朵女孩
天空之城	久石让
Lighters	Bruno Mars
客官不可以	苏仨
秋叶如花	陈瑞
那样的你	宝儿
so sorry	简红
什么都不想要(声动亚洲)	简红
Last Friday Night (T.G.I.F.)	Katy Perry
你快回来	孙楠
大哥	卫兰
一个人唱情歌(旋律版)	带泪的鱼
卡比巴拉的海	宋冬野
沉默是金	陈百强
美女天仙	降央卓玛
串烧	经典老歌,慢摇,宝丽金
风起时,想你	陈楚生
龙猫	宫崎骏
突然的自我	黄小琥
老江湖	黑龙
你是我的主角	贺世哲
明天你好 - 网络歌手 伴奏	牛奶咖啡
Hard Out Here	Lily Allen
Drama, Love & 'Lationships	Babyface
大中国	高枫
今生缘	雷婷
掌声响起来	杭天琪
装糊涂	许嵩
Always Come Back To Your Love	Samantha Mumba
渴死的鱼	DJ
让你猜	丁丁
曾经拥有	Beyond
燃烧吧! 火鸟	高凌风
李伯伯要当红军	张玮玮
我这样的男人	赵小兵
像蝴蝶一样飞	王绎龙
学不会放手	黑龙
Curiosity	Carly Rae Jepsen
爱的血泪史 - dj 传奇制作	龙梅子
卡农	纯音乐
因为爱所以爱	谢霆锋
活泼之泉	雷蒙拉普
无人像你	单色凌
求求你给点力	Mc九局
浪子心声	陈百强
绿度母心咒	印能法师
故乡情	程琳
Cut	Plumb
天煞孤星	郑伊健
北京的冬天	老狼
莫斯科郊外的晚上 - 浪漫萨克斯	萨克斯
Bitchin' Summer	Avril Lavigne
口袋的温度	田馥甄
分手吧是我让你累了	吴爽
一曲相送	图桠格
法海你不懂爱	龚琳娜
Apologize	OneRepublic
生活怎么过	带泪的鱼
爱你的话还没有说出口	祁隆
闲云孤鹤	刘星
摇到外婆桥	小蓓蕾组合
Sing	Ed Sheeran
爱你就让你快乐 - feat	智馨,桐瑶
独自面对	龙梅子
天仙配(树上的鸟儿成双对)	严凤英
如果云知道(声动亚洲)	简红
雁南飞	韩红
不小心	贺世哲
花瓣雨	童安格
再别康桥	蔡琴
回味	彭佳慧
终身美丽	李克勤
绣红旗	彭丽媛
Timeless	Kelly Clarkson,justin guarini
一剪梅	黑鸭子
一路上有你	肖懿航,王矜霖,肖洒,胡维纳,唐一嘉,陈俊豪,田斯斯,六弦
Ring Ring Ring	S.H.E
祝福	叶倩文
单恋高校	陈冠希
白天不懂夜的黑	那英
劳力士男人	赵小兵,冷漠
乌云然	胡歌
Again	Yui
忘情冷雨夜	张学友
心酸	林宥嘉
Sorry, Sorry(쏘리 쏘리)	Super Junior
敖包相会	张绪华
爱的血泪史	龙梅子
Beep Beep	少女时代
春节序曲	中央乐团合唱团
雪之华	中岛美嘉
哈姆雷特的眼泪	孙子涵
Don Giovanni	Richard Clayderman
有什么意义	汪峰
말이야 (话说)	李弘基
伤心城市（DJ版）	云菲菲,冷漠
你不是我（DJ版）	徐良
Some Nights	Fun.
Lady Lady	魏晨
国旗国旗多美丽	幼儿歌曲
友谊之光	玛俐亚
无人之境	陈奕迅
伤心的情歌一夜都唱不完	徐一鸣
The Escapist (Bside)	Nightwish
Alejandro	Lady Gaga
红茶馆	陈慧娴
女人不是妖 - 司徒兰芳  dj 酷 b2013 新 rmx club	dj小苏
时光倒流二十年	陈奕迅
哪一站	陈羽凡,陈俊豪
口弦弦	王二妮
The Riddle	Five For Fighting
流着眼泪唱起歌	大张伟
希望	陈慧琳
小人	赵小兵,冷漠
漂亮的姑娘你别怕 - dj 加快 2013	李贵府
方圆几里	薛之谦
Hush Hush	Avril Lavigne
我用所有报答爱	张靓颖
四季歌	周璇
朋友的酒 - dj 阿圣 2010 - mix	李晓杰
你要离开的一些时候	阿桑
一个人唱情歌(rap版)	带泪的鱼
天下最美	格格
右手边	光良
特别	黄龄
Thank You	Dido
青藏女孩	白玛多吉
让我心碎	赵小兵
Disguise	Lene Marlin
征服(声动亚洲)	简红
南屏晚钟	凤飞飞
家	雅miyavi,MC
珊瑚颂	董文华
因为你爱上他	蒋雪儿
爱情三十六计(声动亚洲)	简红
痴心错对	黑龙
亚洲之夜	罗百吉
远情	谭晶
你心里最后一个	苏打绿
眼泪成诗	孙燕姿
爱情鸟	林依轮
走出你的世界我更寂寞 DJ阿圣	樊少华
小人	赵小兵,冷漠
小步舞曲	陈绮贞
粉刷匠	小蓓蕾组合
老地方的雨	雷婷
漂亮的姑娘你别怕 - dj 加快版	李贵府
潇洒爱一回	黑龙
老师	林妙可,林浩
